index,time,src_ip,dst_ip,tcp_seq,tcp_ack,tcp_len,direction,cumul_sum
1,1576407718.414497,192.168.1.6,192.168.1.4,975077483,2973586253,343,0,-343
2,1576407718.414982,192.168.1.4,192.168.1.6,2973586253,975077826,99,1,-244
3,1576407718.415250,192.168.1.6,192.168.1.4,975077826,2973586352,382,0,-626
4,1576407718.426297,192.168.1.4,192.168.1.6,2973586352,975078208,2266,1,1640
5,1576407718.427182,192.168.1.6,192.168.1.4,975078208,2973588618,74,0,1566
6,1576407718.427303,192.168.1.6,192.168.1.4,975078282,2973588618,245,0,1321
7,1576407718.427800,192.168.1.4,192.168.1.6,2973588618,975078527,79,1,1400
8,1576407718.427811,192.168.1.4,192.168.1.6,2973588697,975078527,79,1,1479
9,1576407718.465091,192.168.1.4,192.168.1.6,2973588776,975078527,91,1,1570
10,1576407718.469567,192.168.1.6,192.168.1.4,975078527,2973588867,539,0,1031
11,1576407718.507366,192.168.1.4,192.168.1.6,2973588867,975079066,2070,1,3101
12,1576407718.548222,192.168.1.4,192.168.1.6,2973590937,975079066,1020,1,4121
13,1576407718.577911,192.168.1.6,192.168.1.4,975079066,2973591957,86,0,4035
14,1576407718.578421,192.168.1.6,192.168.1.4,975079152,2973591957,108,0,3927
15,1576407718.579024,192.168.1.6,192.168.1.4,975079260,2973591957,321,0,3606
16,1576407718.579239,192.168.1.6,192.168.1.4,975079581,2973591957,54,0,3552
17,1576407718.614111,192.168.1.4,192.168.1.6,2973591957,975079635,617,1,4169
18,1576407718.614538,192.168.1.6,192.168.1.4,975079635,2973592574,53,0,4116
19,1576407718.619792,192.168.1.4,192.168.1.6,2973592574,975079688,848,1,4964
20,1576407718.660391,192.168.1.4,192.168.1.6,2973593422,975079688,202,1,5166
21,1576407718.661422,192.168.1.6,192.168.1.4,975079688,2973593624,61,0,5105
22,1576407719.014051,192.168.1.6,192.168.1.4,1972007893,1453219888,343,0,4762
23,1576407719.014593,192.168.1.4,192.168.1.6,1453219888,1972008236,99,1,4861
24,1576407719.014856,192.168.1.6,192.168.1.4,1972008236,1453219987,382,0,4479
25,1576407719.015822,192.168.1.6,192.168.1.4,175292991,4062213065,343,0,4136
26,1576407719.020761,192.168.1.4,192.168.1.6,4062213065,175293334,99,1,4235
27,1576407719.021009,192.168.1.6,192.168.1.4,175293334,4062213164,382,0,3853
28,1576407719.033922,192.168.1.4,192.168.1.6,1453219987,1972008618,2266,1,6119
29,1576407719.034817,192.168.1.6,192.168.1.4,1972008618,1453222253,74,0,6045
30,1576407719.034917,192.168.1.6,192.168.1.4,1972008692,1453222253,235,0,5810
31,1576407719.038205,192.168.1.4,192.168.1.6,4062213164,175293716,2266,1,8076
32,1576407719.038403,192.168.1.4,192.168.1.6,1453222253,1972008927,79,1,8155
33,1576407719.039223,192.168.1.6,192.168.1.4,175293716,4062215430,74,0,8081
34,1576407719.039353,192.168.1.6,192.168.1.4,175293790,4062215430,235,0,7846
35,1576407719.041667,192.168.1.4,192.168.1.6,1453222332,1972008927,79,1,7925
36,1576407719.043270,192.168.1.4,192.168.1.6,4062215430,175294025,79,1,8004
37,1576407719.043435,192.168.1.4,192.168.1.6,4062215509,175294025,79,1,8083
38,1576407719.168745,192.168.1.4,192.168.1.6,1453222411,1972008927,91,1,8174
39,1576407719.168782,192.168.1.4,192.168.1.6,4062215588,175294025,91,1,8265
40,1576407719.170124,192.168.1.6,192.168.1.4,1972008927,1453222502,539,0,7726
41,1576407719.171214,192.168.1.6,192.168.1.4,175294025,4062215679,539,0,7187
42,1576407719.261796,192.168.1.4,192.168.1.6,1453222502,1972009466,2070,1,9257
43,1576407719.304834,192.168.1.4,192.168.1.6,1453224572,1972009466,2143,1,11400
44,1576407719.312608,192.168.1.4,192.168.1.6,4062215679,175294564,1385,1,12785
45,1576407719.351713,192.168.1.6,192.168.1.4,1972009466,1453226715,102,0,12683
46,1576407719.354480,192.168.1.6,192.168.1.4,1972009568,1453226715,521,0,12162
47,1576407719.356588,192.168.1.4,192.168.1.6,4062217064,175294564,2828,1,14990
48,1576407719.359955,192.168.1.6,192.168.1.4,175294564,4062219892,102,0,14888
49,1576407719.400951,192.168.1.4,192.168.1.6,1453226715,1972010089,4717,1,19605
50,1576407719.401522,192.168.1.4,192.168.1.6,4062219892,175294666,628,1,20233
51,1576407719.401887,192.168.1.4,192.168.1.6,1453231432,1972010089,1245,1,21478
52,1576407719.511942,192.168.1.6,192.168.1.4,1972010089,1453232677,388,0,21090
53,1576407719.513971,192.168.1.6,192.168.1.4,175294666,4062220520,390,0,20700
54,1576407719.516329,192.168.1.6,192.168.1.4,1468314057,3464397283,343,0,20357
55,1576407719.516949,192.168.1.4,192.168.1.6,3464397283,1468314400,99,1,20456
56,1576407719.517168,192.168.1.6,192.168.1.4,1468314400,3464397382,382,0,20074
57,1576407719.518751,192.168.1.6,192.168.1.4,2681920720,267330767,343,0,19731
58,1576407719.521818,192.168.1.6,192.168.1.4,3256942099,2576486427,343,0,19388
59,1576407719.522347,192.168.1.4,192.168.1.6,267330767,2681921063,99,1,19487
60,1576407719.522632,192.168.1.6,192.168.1.4,2681921063,267330866,382,0,19105
61,1576407719.532775,192.168.1.4,192.168.1.6,2576486427,3256942442,99,1,19204
62,1576407719.533404,192.168.1.6,192.168.1.4,3256942442,2576486526,382,0,18822
63,1576407719.544240,192.168.1.4,192.168.1.6,3464397382,1468314782,2266,1,21088
64,1576407719.545549,192.168.1.6,192.168.1.4,1468314782,3464399648,74,0,21014
65,1576407719.545648,192.168.1.6,192.168.1.4,1468314856,3464399648,235,0,20779
66,1576407719.551959,192.168.1.4,192.168.1.6,2576486526,3256942824,2266,1,23045
67,1576407719.552171,192.168.1.4,192.168.1.6,3464399648,1468315091,79,1,23124
68,1576407719.552318,192.168.1.4,192.168.1.6,3464399727,1468315091,79,1,23203
69,1576407719.553220,192.168.1.6,192.168.1.4,3256942824,2576488792,74,0,23129
70,1576407719.553310,192.168.1.6,192.168.1.4,3256942898,2576488792,235,0,22894
71,1576407719.556218,192.168.1.4,192.168.1.6,267330866,2681921445,2266,1,25160
72,1576407719.556772,192.168.1.4,192.168.1.6,2576488792,3256943133,79,1,25239
73,1576407719.556783,192.168.1.4,192.168.1.6,2576488871,3256943133,79,1,25318
74,1576407719.557399,192.168.1.6,192.168.1.4,2681921445,267333132,74,0,25244
75,1576407719.557490,192.168.1.6,192.168.1.4,2681921519,267333132,235,0,25009
76,1576407719.558082,192.168.1.4,192.168.1.6,267333132,2681921754,79,1,25088
77,1576407719.558243,192.168.1.4,192.168.1.6,267333211,2681921754,79,1,25167
