index,time,src_ip,dst_ip,tcp_seq,tcp_ack,tcp_len,direction,cumul_sum
1,1576412371.959380,192.168.1.6,192.168.1.4,1824824019,1022763415,343,0,-343
2,1576412371.959985,192.168.1.4,192.168.1.6,1022763415,1824824362,99,1,-244
3,1576412371.960218,192.168.1.6,192.168.1.4,1824824362,1022763514,382,0,-626
4,1576412371.971547,192.168.1.4,192.168.1.6,1022763514,1824824744,2266,1,1640
5,1576412371.972390,192.168.1.6,192.168.1.4,1824824744,1022765780,74,0,1566
6,1576412371.972523,192.168.1.6,192.168.1.4,1824824818,1022765780,245,0,1321
7,1576412371.972846,192.168.1.4,192.168.1.6,1022765780,1824825063,79,1,1400
8,1576412371.973312,192.168.1.4,192.168.1.6,1022765859,1824825063,79,1,1479
9,1576412372.008827,192.168.1.4,192.168.1.6,1022765938,1824825063,91,1,1570
10,1576412372.009325,192.168.1.6,192.168.1.4,1824825063,1022766029,539,0,1031
11,1576412372.050491,192.168.1.4,192.168.1.6,1022766029,1824825602,1385,1,2416
12,1576412372.093524,192.168.1.4,192.168.1.6,1022767414,1824825602,1705,1,4121
13,1576412372.114224,192.168.1.6,192.168.1.4,1824825602,1022769119,86,0,4035
14,1576412372.114749,192.168.1.6,192.168.1.4,1824825688,1022769119,108,0,3927
15,1576412372.115343,192.168.1.6,192.168.1.4,1824825796,1022769119,321,0,3606
16,1576412372.115522,192.168.1.6,192.168.1.4,1824826117,1022769119,54,0,3552
17,1576412372.139699,192.168.1.4,192.168.1.6,1022769119,1824826171,617,1,4169
18,1576412372.141535,192.168.1.6,192.168.1.4,1824826171,1022769736,53,0,4116
19,1576412372.159763,192.168.1.4,192.168.1.6,1022769736,1824826224,766,1,4882
20,1576412372.201321,192.168.1.4,192.168.1.6,1022770502,1824826224,744,1,5626
21,1576412372.202004,192.168.1.6,192.168.1.4,1824826224,1022771246,61,0,5565
22,1576412372.550271,192.168.1.6,192.168.1.4,2420486060,642685377,343,0,5222
23,1576412372.550889,192.168.1.4,192.168.1.6,642685377,2420486403,99,1,5321
24,1576412372.551147,192.168.1.6,192.168.1.4,2420486403,642685476,382,0,4939
25,1576412372.552609,192.168.1.6,192.168.1.4,997729745,4163526410,343,0,4596
26,1576412372.557636,192.168.1.4,192.168.1.6,4163526410,997730088,99,1,4695
27,1576412372.557940,192.168.1.6,192.168.1.4,997730088,4163526509,382,0,4313
28,1576412372.572628,192.168.1.4,192.168.1.6,642685476,2420486785,2266,1,6579
29,1576412372.573679,192.168.1.6,192.168.1.4,2420486785,642687742,74,0,6505
30,1576412372.573800,192.168.1.6,192.168.1.4,2420486859,642687742,233,0,6272
31,1576412372.577196,192.168.1.4,192.168.1.6,4163526509,997730470,2266,1,8538
32,1576412372.577329,192.168.1.4,192.168.1.6,642687742,2420487092,79,1,8617
33,1576412372.577438,192.168.1.4,192.168.1.6,642687821,2420487092,79,1,8696
34,1576412372.578540,192.168.1.6,192.168.1.4,997730470,4163528775,74,0,8622
35,1576412372.578714,192.168.1.6,192.168.1.4,997730544,4163528775,233,0,8389
36,1576412372.579563,192.168.1.4,192.168.1.6,4163528775,997730777,79,1,8468
37,1576412372.580034,192.168.1.4,192.168.1.6,4163528854,997730777,79,1,8547
38,1576412373.000305,192.168.1.4,192.168.1.6,4163528933,997730777,91,1,8638
39,1576412373.001434,192.168.1.6,192.168.1.4,997730777,4163529024,539,0,8099
40,1576412373.003543,192.168.1.4,192.168.1.6,642687900,2420487092,91,1,8190
41,1576412373.004515,192.168.1.6,192.168.1.4,2420487092,642687991,539,0,7651
42,1576412373.436509,192.168.1.4,192.168.1.6,4163529024,997731316,1385,1,9036
43,1576412373.438490,192.168.1.4,192.168.1.6,642687991,2420487631,2070,1,11106
44,1576412373.477584,192.168.1.4,192.168.1.6,4163530409,997731316,2349,1,13455
45,1576412373.481367,192.168.1.4,192.168.1.6,642690061,2420487631,1664,1,15119
46,1576412373.486452,192.168.1.6,192.168.1.4,997731316,4163532758,86,0,15033
47,1576412373.486944,192.168.1.6,192.168.1.4,2420487631,642691725,86,0,14947
48,1576412373.488813,192.168.1.6,192.168.1.4,997731402,4163532758,520,0,14427
49,1576412374.451016,192.168.1.4,192.168.1.6,4163532758,997731922,600,1,15027
50,1576412374.492564,192.168.1.4,192.168.1.6,4163533358,997731922,5792,1,20819
51,1576412374.492956,192.168.1.4,192.168.1.6,4163539150,997731922,2929,1,23748
52,1576412374.580125,192.168.1.6,192.168.1.4,997731922,4163542079,557,0,23191
53,1576412374.581414,192.168.1.6,192.168.1.4,2420487717,642691725,577,0,22614
54,1576412374.584070,192.168.1.6,192.168.1.4,4238287761,2370078037,343,0,22271
55,1576412374.584471,192.168.1.4,192.168.1.6,2370078037,4238288104,99,1,22370
56,1576412374.584761,192.168.1.6,192.168.1.4,4238288104,2370078136,382,0,21988
57,1576412374.596393,192.168.1.4,192.168.1.6,2370078136,4238288486,2266,1,24254
58,1576412374.597317,192.168.1.6,192.168.1.4,4238288486,2370080402,74,0,24180
59,1576412374.597441,192.168.1.6,192.168.1.4,4238288560,2370080402,233,0,23947
60,1576412374.597903,192.168.1.4,192.168.1.6,2370080402,4238288793,79,1,24026
61,1576412374.597976,192.168.1.4,192.168.1.6,2370080481,4238288793,79,1,24105
62,1576412374.776926,192.168.1.4,192.168.1.6,4163542079,997732479,1385,1,25490
63,1576412374.811122,192.168.1.4,192.168.1.6,4163543464,997732479,1385,1,26875
64,1576412374.811170,192.168.1.4,192.168.1.6,4163544849,997732479,1385,1,28260
65,1576412374.839838,192.168.1.4,192.168.1.6,4163546234,997732479,1497,1,29757
66,1576412374.842487,192.168.1.4,192.168.1.6,4163547731,997732479,1385,1,31142
67,1576412374.845805,192.168.1.4,192.168.1.6,4163549116,997732479,2896,1,34038
68,1576412374.846040,192.168.1.4,192.168.1.6,4163552012,997732479,1215,1,35253
69,1576412374.849475,192.168.1.4,192.168.1.6,4163553227,997732479,1385,1,36638
70,1576412374.857659,192.168.1.4,192.168.1.6,4163554612,997732479,116,1,36754
71,1576412374.866462,192.168.1.4,192.168.1.6,642691725,2420488294,2070,1,38824
72,1576412374.866632,192.168.1.4,192.168.1.6,4163554728,997732479,2896,1,41720
73,1576412374.866683,192.168.1.4,192.168.1.6,4163557624,997732479,2061,1,43781
74,1576412374.911989,192.168.1.4,192.168.1.6,642693795,2420488294,14480,1,58261
75,1576412374.914563,192.168.1.4,192.168.1.6,642708275,2420488294,902,1,59163
76,1576412375.048472,192.168.1.4,192.168.1.6,4163559685,997732479,2070,1,61233
77,1576412375.092143,192.168.1.4,192.168.1.6,4163561755,997732479,5792,1,67025
78,1576412375.092203,192.168.1.4,192.168.1.6,4163567547,997732479,8538,1,75563
79,1576412375.092308,192.168.1.4,192.168.1.6,2370080560,4238288793,91,1,75654
80,1576412375.093284,192.168.1.6,192.168.1.4,4238288793,2370080651,539,0,75115
81,1576412375.107202,192.168.1.4,192.168.1.6,642709177,2420488294,4344,1,79459
82,1576412375.107512,192.168.1.4,192.168.1.6,642713521,2420488294,927,1,80386
83,1576412375.109035,192.168.1.6,192.168.1.4,2420488294,642714448,553,0,79833
84,1576412375.114940,192.168.1.6,192.168.1.4,2910081332,25590794,343,0,79490
85,1576412375.115561,192.168.1.4,192.168.1.6,25590794,2910081675,99,1,79589
86,1576412375.115763,192.168.1.6,192.168.1.4,2910081675,25590893,382,0,79207
87,1576412375.125846,192.168.1.4,192.168.1.6,25590893,2910082057,2266,1,81473
88,1576412375.126634,192.168.1.6,192.168.1.4,2910082057,25593159,74,0,81399
89,1576412375.126727,192.168.1.6,192.168.1.4,2910082131,25593159,233,0,81166
90,1576412375.126989,192.168.1.4,192.168.1.6,25593159,2910082131,79,1,81245
91,1576412375.127147,192.168.1.4,192.168.1.6,25593238,2910082364,79,1,81324
92,1576412375.250380,192.168.1.4,192.168.1.6,4163576085,997732479,1385,1,82709
93,1576412375.294066,192.168.1.4,192.168.1.6,4163577470,997732479,5792,1,88501
94,1576412375.294230,192.168.1.4,192.168.1.6,4163583262,997732479,8688,1,97189
95,1576412375.294605,192.168.1.4,192.168.1.6,4163591950,997732479,535,1,97724
96,1576412375.325882,192.168.1.4,192.168.1.6,2370080651,4238289332,2070,1,99794
97,1576412375.328402,192.168.1.4,192.168.1.6,642714448,2420488847,2070,1,101864
98,1576412375.342081,192.168.1.4,192.168.1.6,25593317,2910082364,91,1,101955
99,1576412375.342448,192.168.1.6,192.168.1.4,2910082364,25593408,539,0,101416
100,1576412375.367669,192.168.1.4,192.168.1.6,2370082721,4238289332,1664,1,103080
101,1576412375.368995,192.168.1.6,192.168.1.4,4238289332,2370084385,605,0,102475
102,1576412375.371718,192.168.1.4,192.168.1.6,642716518,2420488847,8688,1,111163
103,1576412375.371847,192.168.1.4,192.168.1.6,642725206,2420488847,5792,1,116955
104,1576412375.372132,192.168.1.4,192.168.1.6,642730998,2420488847,68,1,117023
105,1576412375.607226,192.168.1.4,192.168.1.6,4163592485,997732479,1385,1,118408
106,1576412375.633287,192.168.1.4,192.168.1.6,4163593870,997732479,4118,1,122526
107,1576412375.640788,192.168.1.4,192.168.1.6,642731066,2420488847,2748,1,125274
108,1576412375.656548,192.168.1.4,192.168.1.6,642733814,2420488847,6837,1,132111
109,1576412375.664208,192.168.1.4,192.168.1.6,642740651,2420488847,6990,1,139101
110,1576412375.666938,192.168.1.6,192.168.1.4,2420488847,642747641,472,0,138629
111,1576412375.668545,192.168.1.4,192.168.1.6,2370084385,4238289937,2070,1,140699
112,1576412375.668681,192.168.1.4,192.168.1.6,25593408,2910082903,2070,1,142769
113,1576412375.675714,192.168.1.4,192.168.1.6,4163597988,997732479,5792,1,148561
114,1576412375.675932,192.168.1.4,192.168.1.6,4163603780,997732479,5127,1,153688
115,1576412375.711639,192.168.1.4,192.168.1.6,2370086455,4238289937,14480,1,168168
116,1576412375.711778,192.168.1.4,192.168.1.6,25595478,2910082903,1664,1,169832
117,1576412375.712202,192.168.1.4,192.168.1.6,2370100935,4238289937,902,1,170734
118,1576412375.714770,192.168.1.6,192.168.1.4,2910082903,25597142,86,0,170648
119,1576412375.806286,192.168.1.4,192.168.1.6,4163608907,997732479,4344,1,174992
120,1576412375.807376,192.168.1.4,192.168.1.6,4163613251,997732479,10671,1,185663
121,1576412375.842076,192.168.1.4,192.168.1.6,2370101837,4238289937,6837,1,192500
122,1576412375.844537,192.168.1.4,192.168.1.6,2370108674,4238289937,4111,1,196611
123,1576412375.844563,192.168.1.4,192.168.1.6,642747641,2420489319,2070,1,198681
124,1576412375.848082,192.168.1.4,192.168.1.6,4163623922,997732479,7240,1,205921
125,1576412375.848245,192.168.1.4,192.168.1.6,4163631162,997732479,9166,1,215087
126,1576412375.848306,192.168.1.4,192.168.1.6,4163640328,997732479,7240,1,222327
127,1576412375.848560,192.168.1.4,192.168.1.6,4163647568,997732479,4344,1,226671
128,1576412375.848580,192.168.1.4,192.168.1.6,4163651912,997732479,4766,1,231437
129,1576412375.852232,192.168.1.4,192.168.1.6,2370112785,4238289937,1385,1,232822
130,1576412375.887316,192.168.1.4,192.168.1.6,642749711,2420489319,8688,1,241510
131,1576412375.887435,192.168.1.4,192.168.1.6,642758399,2420489319,5650,1,247160
132,1576412375.899710,192.168.1.6,192.168.1.4,2420489319,642764049,589,0,246571
133,1576412375.997916,192.168.1.4,192.168.1.6,4163656678,997732479,12289,1,258860
134,1576412376.025856,192.168.1.4,192.168.1.6,4163668967,997732479,8200,1,267060
135,1576412376.047356,192.168.1.4,192.168.1.6,2370114170,4238289937,6837,1,273897
136,1576412376.047583,192.168.1.4,192.168.1.6,4163677167,997732479,7552,1,281449
137,1576412376.049136,192.168.1.4,192.168.1.6,2370121007,4238289937,8200,1,289649
138,1576412376.056942,192.168.1.4,192.168.1.6,2370129207,4238289937,1385,1,291034
139,1576412376.079863,192.168.1.4,192.168.1.6,642764049,2420489908,2070,1,293104
140,1576412376.120554,192.168.1.6,192.168.1.4,997732479,4163684719,560,0,292544
141,1576412376.122010,192.168.1.6,192.168.1.4,2910082989,25597142,543,0,292001
142,1576412376.123261,192.168.1.4,192.168.1.6,642766119,2420489908,16406,1,308407
143,1576412376.123431,192.168.1.4,192.168.1.6,642782525,2420489908,11584,1,319991
144,1576412376.123536,192.168.1.4,192.168.1.6,642794109,2420489908,1501,1,321492
145,1576412376.126303,192.168.1.6,192.168.1.4,1556771052,4061374181,343,0,321149
146,1576412376.133751,192.168.1.6,192.168.1.4,2420489908,642795610,544,0,320605
147,1576412376.136349,192.168.1.4,192.168.1.6,4061374181,1556771395,99,1,320704
148,1576412376.136736,192.168.1.6,192.168.1.4,1556771395,4061374280,382,0,320322
149,1576412376.142422,192.168.1.6,192.168.1.4,1293276343,1428221865,343,0,319979
150,1576412376.148015,192.168.1.4,192.168.1.6,1428221865,1293276686,99,1,320078
151,1576412376.148630,192.168.1.6,192.168.1.4,1293276686,1428221964,382,0,319696
152,1576412376.156957,192.168.1.6,192.168.1.4,3214647624,371095726,343,0,319353
153,1576412376.158374,192.168.1.6,192.168.1.4,825406670,1103409613,343,0,319010
154,1576412376.158753,192.168.1.4,192.168.1.6,4061374280,1556771777,2266,1,321276
155,1576412376.159347,192.168.1.4,192.168.1.6,371095726,3214647967,99,1,321375
156,1576412376.159675,192.168.1.6,192.168.1.4,1556771777,4061376546,74,0,321301
157,1576412376.159759,192.168.1.6,192.168.1.4,1556771851,4061376546,233,0,321068
158,1576412376.160171,192.168.1.6,192.168.1.4,3214647967,371095825,382,0,320686
159,1576412376.163521,192.168.1.4,192.168.1.6,4061376546,1556772084,79,1,320765
160,1576412376.163650,192.168.1.4,192.168.1.6,4061376625,1556772084,79,1,320844
161,1576412376.165171,192.168.1.4,192.168.1.6,1103409613,825407013,99,1,320943
162,1576412376.165388,192.168.1.6,192.168.1.4,825407013,1103409712,382,0,320561
163,1576412376.170068,192.168.1.4,192.168.1.6,1428221964,1293277068,2266,1,322827
164,1576412376.171381,192.168.1.6,192.168.1.4,1293277068,1428224230,74,0,322753
165,1576412376.171472,192.168.1.6,192.168.1.4,1293277142,1428224230,233,0,322520
166,1576412376.178760,192.168.1.4,192.168.1.6,1428224230,1293277375,79,1,322599
167,1576412376.178886,192.168.1.4,192.168.1.6,1428224309,1293277375,79,1,322678
168,1576412376.193633,192.168.1.4,192.168.1.6,371095825,3214648349,2266,1,324944
169,1576412376.194817,192.168.1.6,192.168.1.4,3214648349,371098091,74,0,324870
170,1576412376.194909,192.168.1.6,192.168.1.4,3214648423,371098091,255,0,324615
171,1576412376.195610,192.168.1.4,192.168.1.6,371098091,3214648678,79,1,324694
172,1576412376.195625,192.168.1.4,192.168.1.6,371098170,3214648678,79,1,324773
173,1576412376.200796,192.168.1.4,192.168.1.6,1103409712,825407395,2266,1,327039
174,1576412376.201616,192.168.1.6,192.168.1.4,825407395,1103411978,74,0,326965
175,1576412376.201731,192.168.1.6,192.168.1.4,825407469,1103411978,255,0,326710
176,1576412376.217241,192.168.1.4,192.168.1.6,2370130592,4238289937,2070,1,328780
177,1576412376.217391,192.168.1.4,192.168.1.6,1103411978,825407724,79,1,328859
178,1576412376.217495,192.168.1.4,192.168.1.6,1103412057,825407724,79,1,328938
179,1576412376.250671,192.168.1.4,192.168.1.6,371098249,3214648678,91,1,329029
180,1576412376.251067,192.168.1.6,192.168.1.4,3214648678,371098340,539,0,328490
181,1576412376.261233,192.168.1.4,192.168.1.6,2370132662,4238289937,12967,1,341457
182,1576412376.268296,192.168.1.4,192.168.1.6,1103412136,825407724,91,1,341548
183,1576412376.268731,192.168.1.6,192.168.1.4,825407724,1103412227,539,0,341009
184,1576412376.303233,192.168.1.4,192.168.1.6,2370145629,4238289937,1385,1,342394
185,1576412376.304420,192.168.1.4,192.168.1.6,25597142,2910083532,2070,1,344464
186,1576412376.337188,192.168.1.4,192.168.1.6,371098340,3214649217,2070,1,346534
187,1576412376.344592,192.168.1.4,192.168.1.6,4163684719,997733039,2070,1,348604
188,1576412376.345269,192.168.1.4,192.168.1.6,4163686789,997733039,2070,1,350674
189,1576412376.347454,192.168.1.4,192.168.1.6,25599212,2910083532,14480,1,365154
190,1576412376.349403,192.168.1.4,192.168.1.6,25613692,2910083532,68,1,365222
191,1576412376.380017,192.168.1.4,192.168.1.6,371100410,3214649217,1250,1,366472
192,1576412376.386096,192.168.1.6,192.168.1.4,3214649217,371101660,86,0,366386
193,1576412376.387063,192.168.1.4,192.168.1.6,4163688859,997733039,9556,1,375942
194,1576412376.387522,192.168.1.6,192.168.1.4,3214649303,371101660,108,0,375834
195,1576412376.390377,192.168.1.6,192.168.1.4,3214649411,371101660,277,0,375557
196,1576412376.404294,192.168.1.4,192.168.1.6,1103412227,825408263,2070,1,377627
197,1576412376.431162,192.168.1.4,192.168.1.6,4163698415,997733039,4319,1,381946
198,1576412376.447110,192.168.1.4,192.168.1.6,1103414297,825408263,1250,1,383196
199,1576412376.449642,192.168.1.4,192.168.1.6,4163702734,997733039,2070,1,385266
200,1576412376.449798,192.168.1.4,192.168.1.6,4163704804,997733039,700,1,385966
201,1576412376.454101,192.168.1.6,192.168.1.4,825408263,1103415547,86,0,385880
202,1576412376.454335,192.168.1.4,192.168.1.6,4163705504,997733039,1385,1,387265
203,1576412376.454423,192.168.1.6,192.168.1.4,825408349,1103415547,108,0,387157
204,1576412376.455096,192.168.1.6,192.168.1.4,825408457,1103415547,269,0,386888
205,1576412376.458551,192.168.1.4,192.168.1.6,4163706889,997733039,1385,1,388273
206,1576412376.463715,192.168.1.4,192.168.1.6,642795610,2420490452,2070,1,390343
207,1576412376.464435,192.168.1.4,192.168.1.6,2370147014,4238289937,1385,1,391728
208,1576412376.493891,192.168.1.4,192.168.1.6,371101660,3214649688,1057,1,392785
209,1576412376.499290,192.168.1.4,192.168.1.6,4163708274,997733039,6246,1,399031
210,1576412376.504544,192.168.1.4,192.168.1.6,25613760,2910083532,1001,1,400032
211,1576412376.505393,192.168.1.6,192.168.1.4,3214649688,371102717,53,0,399979
212,1576412376.505764,192.168.1.4,192.168.1.6,371102717,3214649741,11584,1,411563
213,1576412376.505913,192.168.1.4,192.168.1.6,371114301,3214649741,2896,1,414459
214,1576412376.506065,192.168.1.4,192.168.1.6,371117197,3214649741,1915,1,416374
215,1576412376.507137,192.168.1.4,192.168.1.6,2370148399,4238289937,14480,1,430854
216,1576412376.507257,192.168.1.4,192.168.1.6,2370162879,4238289937,1926,1,432780
217,1576412376.507817,192.168.1.4,192.168.1.6,2370164805,4238289937,10898,1,443678
218,1576412376.508026,192.168.1.4,192.168.1.6,642797680,2420490452,5792,1,449470
219,1576412376.508301,192.168.1.4,192.168.1.6,642803472,2420490452,6044,1,455514
220,1576412376.508320,192.168.1.4,192.168.1.6,1103415547,825408726,2070,1,457584
221,1576412376.521904,192.168.1.4,192.168.1.6,4061376704,1556772084,91,1,457675
222,1576412376.523484,192.168.1.4,192.168.1.6,1428224388,1293277375,91,1,457766
223,1576412376.530420,192.168.1.6,192.168.1.4,1556772084,4061376795,539,0,457227
224,1576412376.531115,192.168.1.6,192.168.1.4,1293277375,1428224479,539,0,456688
225,1576412376.535912,192.168.1.6,192.168.1.4,825408726,1103417617,53,0,456635
226,1576412376.536398,192.168.1.4,192.168.1.6,1103417617,825408779,11584,1,468219
227,1576412376.536518,192.168.1.4,192.168.1.6,1103429201,825408779,2896,1,471115
228,1576412376.536682,192.168.1.4,192.168.1.6,1103432097,825408779,902,1,472017
229,1576412376.552234,192.168.1.6,192.168.1.4,997733039,4163714520,563,0,471454
230,1576412376.553282,192.168.1.6,192.168.1.4,2910083532,25614761,545,0,470909
231,1576412376.558646,192.168.1.6,192.168.1.4,2420490452,642809516,564,0,470345
232,1576412376.565511,192.168.1.4,192.168.1.6,371119112,3214649741,2070,1,472415
233,1576412376.565526,192.168.1.4,192.168.1.6,371121182,3214649741,700,1,473115
234,1576412376.568096,192.168.1.4,192.168.1.6,371121882,3214649741,2070,1,475185
235,1576412376.568303,192.168.1.4,192.168.1.6,371123952,3214649741,2070,1,477255
236,1576412376.568434,192.168.1.4,192.168.1.6,371126022,3214649741,2070,1,479325
237,1576412376.568608,192.168.1.4,192.168.1.6,371128092,3214649741,1937,1,481262
238,1576412376.569542,192.168.1.6,192.168.1.4,3214649741,371130029,61,0,481201
239,1576412376.579354,192.168.1.4,192.168.1.6,1103432999,825408779,1733,1,482934
240,1576412376.579918,192.168.1.6,192.168.1.4,825408779,1103434732,61,0,482873
241,1576412376.638621,192.168.1.4,192.168.1.6,2370175703,4238289937,4111,1,486984
242,1576412376.638661,192.168.1.4,192.168.1.6,2370179814,4238289937,16406,1,503390
243,1576412376.638690,192.168.1.4,192.168.1.6,2370196220,4238289937,1357,1,504747
244,1576412376.640415,192.168.1.4,192.168.1.6,2370197577,4238289937,1385,1,506132
245,1576412376.697553,192.168.1.4,192.168.1.6,2370198962,4238289937,8200,1,514332
246,1576412376.707109,192.168.1.4,192.168.1.6,2370207162,4238289937,1385,1,515717
247,1576412376.712802,192.168.1.4,192.168.1.6,2370208547,4238289937,2748,1,518465
248,1576412376.718049,192.168.1.4,192.168.1.6,1428224479,1293277914,2070,1,520535
249,1576412376.718066,192.168.1.4,192.168.1.6,4061376795,1556772623,2070,1,522605
250,1576412376.718364,192.168.1.4,192.168.1.6,2370211295,4238289937,1385,1,523990
251,1576412376.763645,192.168.1.4,192.168.1.6,4061378865,1556772623,1664,1,525654
252,1576412376.763742,192.168.1.4,192.168.1.6,1428226549,1293277914,1664,1,527318
253,1576412376.764789,192.168.1.6,192.168.1.4,1556772623,4061380529,86,0,527232
254,1576412376.765570,192.168.1.6,192.168.1.4,1293277914,1428228213,86,0,527146
255,1576412376.766471,192.168.1.6,192.168.1.4,1556772709,4061380529,675,0,526471
256,1576412376.767178,192.168.1.6,192.168.1.4,1293278000,1428228213,576,0,525895
257,1576412376.812447,192.168.1.4,192.168.1.6,2370212680,4238289937,15015,1,540910
258,1576412376.813087,192.168.1.4,192.168.1.6,2370227695,4238289937,2748,1,543658
259,1576412376.815313,192.168.1.4,192.168.1.6,25614761,2910084077,1385,1,545043
260,1576412376.815564,192.168.1.4,192.168.1.6,4163714520,997733602,1447,1,546490
261,1576412376.815608,192.168.1.4,192.168.1.6,2370230443,4238289937,3370,1,549860
262,1576412376.816219,192.168.1.4,192.168.1.6,25616146,2910084077,7240,1,557100
263,1576412376.816341,192.168.1.4,192.168.1.6,25623386,2910084077,2102,1,559202
264,1576412376.816490,192.168.1.4,192.168.1.6,642809516,2420491016,1473,1,560675
265,1576412376.833274,192.168.1.6,192.168.1.4,997733602,4163715967,581,0,560094
266,1576412376.834358,192.168.1.6,192.168.1.4,2910084077,25625488,584,0,559510
267,1576412376.839460,192.168.1.4,192.168.1.6,642810989,2420491016,7240,1,566750
268,1576412376.839601,192.168.1.4,192.168.1.6,2370233813,4238289937,1385,1,568135
269,1576412376.839664,192.168.1.4,192.168.1.6,642818229,2420491016,7240,1,575375
270,1576412376.839759,192.168.1.4,192.168.1.6,642825469,2420491016,14480,1,589855
271,1576412376.839869,192.168.1.4,192.168.1.6,642839949,2420491016,2433,1,592288
272,1576412376.841565,192.168.1.6,192.168.1.4,825408840,1103434732,321,0,591967
273,1576412376.842876,192.168.1.4,192.168.1.6,642842382,2420491016,2671,1,594638
274,1576412376.847802,192.168.1.4,192.168.1.6,2370235198,4238289937,2748,1,597386
275,1576412376.848819,192.168.1.4,192.168.1.6,2370237946,4238289937,2748,1,600134
276,1576412376.851757,192.168.1.4,192.168.1.6,2370240694,4238289937,5474,1,605608
277,1576412376.853701,192.168.1.6,192.168.1.4,2420491016,642845053,658,0,604950
278,1576412376.870638,192.168.1.4,192.168.1.6,2370246168,4238289937,5474,1,610424
279,1576412376.924699,192.168.1.4,192.168.1.6,1103434732,825409161,348,1,610772
280,1576412376.928724,192.168.1.4,192.168.1.6,2370251642,4238289937,6837,1,617609
281,1576412376.934538,192.168.1.6,192.168.1.4,825409161,1103435080,57,0,617552
282,1576412376.935171,192.168.1.4,192.168.1.6,1103435080,825409218,542,1,618094
283,1576412376.936500,192.168.1.6,192.168.1.4,1038632670,3399176297,343,0,617751
284,1576412376.937043,192.168.1.4,192.168.1.6,3399176297,1038633013,99,1,617850
285,1576412376.937247,192.168.1.6,192.168.1.4,1038633013,3399176396,382,0,617468
286,1576412376.937508,192.168.1.6,192.168.1.4,825409218,1103435622,61,0,617407
287,1576412376.948582,192.168.1.4,192.168.1.6,3399176396,1038633395,2266,1,619673
288,1576412376.949559,192.168.1.6,192.168.1.4,1038633395,3399178662,74,0,619599
289,1576412376.949649,192.168.1.6,192.168.1.4,1038633469,3399178662,253,0,619346
290,1576412376.950049,192.168.1.4,192.168.1.6,3399178662,1038633722,79,1,619425
291,1576412376.950169,192.168.1.4,192.168.1.6,3399178741,1038633722,79,1,619504
292,1576412376.956640,192.168.1.4,192.168.1.6,1428228213,1293278576,1385,1,620889
293,1576412376.968371,192.168.1.4,192.168.1.6,4061380529,1556773384,2070,1,622959
294,1576412376.990273,192.168.1.4,192.168.1.6,2370258479,4238289937,1385,1,624344
295,1576412376.998740,192.168.1.4,192.168.1.6,1428229598,1293278576,5792,1,630136
296,1576412376.999036,192.168.1.4,192.168.1.6,1428235390,1293278576,8688,1,638824
297,1576412376.999056,192.168.1.4,192.168.1.6,1428244078,1293278576,1587,1,640411
298,1576412377.002821,192.168.1.4,192.168.1.6,2370259864,4238289937,5474,1,645885
299,1576412377.003598,192.168.1.4,192.168.1.6,2370265338,4238289937,5474,1,651359
300,1576412377.006206,192.168.1.4,192.168.1.6,2370270812,4238289937,10926,1,662285
301,1576412377.010803,192.168.1.4,192.168.1.6,4061382599,1556773384,14480,1,676765
302,1576412377.011082,192.168.1.4,192.168.1.6,4061397079,1556773384,902,1,677667
303,1576412377.027339,192.168.1.4,192.168.1.6,25625488,2910084661,1385,1,679052
304,1576412377.067824,192.168.1.4,192.168.1.6,4163715967,997734183,1473,1,680525
305,1576412377.070995,192.168.1.4,192.168.1.6,25626873,2910084661,2896,1,683421
306,1576412377.071228,192.168.1.4,192.168.1.6,25629769,2910084661,2892,1,686313
307,1576412377.078520,192.168.1.4,192.168.1.6,642845053,2420491674,2070,1,688383
308,1576412377.078938,192.168.1.4,192.168.1.6,2370281738,4238289937,10926,1,699309
309,1576412377.083141,192.168.1.4,192.168.1.6,3399178820,1038633722,91,1,699400
310,1576412377.088701,192.168.1.6,192.168.1.4,1038633722,3399178911,539,0,698861
311,1576412377.093133,192.168.1.6,192.168.1.4,2910084661,25632661,655,0,698206
312,1576412377.110879,192.168.1.4,192.168.1.6,4163717440,997734183,14480,1,712686
313,1576412377.111156,192.168.1.4,192.168.1.6,4163731920,997734183,3685,1,716371
314,1576412377.112676,192.168.1.6,192.168.1.4,997734183,4163735605,660,0,715711
315,1576412377.118637,192.168.1.4,192.168.1.6,642847123,2420491674,4981,1,720692
316,1576412377.122575,192.168.1.6,192.168.1.4,2420491674,642852104,654,0,720038
317,1576412377.133384,192.168.1.4,192.168.1.6,3399178911,1038634261,1385,1,721423
318,1576412377.174760,192.168.1.4,192.168.1.6,3399180296,1038634261,1530,1,722953
319,1576412377.180210,192.168.1.6,192.168.1.4,1038634261,3399181826,86,0,722867
320,1576412377.185283,192.168.1.6,192.168.1.4,1038634347,3399181826,108,0,722759
321,1576412377.187042,192.168.1.6,192.168.1.4,1038634455,3399181826,397,0,722362
322,1576412377.221400,192.168.1.4,192.168.1.6,2370292664,4238289937,15015,1,737377
323,1576412377.221944,192.168.1.4,192.168.1.6,2370307679,4238289937,2748,1,740125
324,1576412377.267033,192.168.1.4,192.168.1.6,2370310427,4238289937,1385,1,741510
325,1576412377.270117,192.168.1.4,192.168.1.6,1428245665,1293278576,4111,1,745621
326,1576412377.270418,192.168.1.4,192.168.1.6,2370311812,4238289937,4111,1,749732
327,1576412377.276015,192.168.1.4,192.168.1.6,1428249776,1293278576,2896,1,752628
328,1576412377.276280,192.168.1.4,192.168.1.6,1428252672,1293278576,6667,1,759295
329,1576412377.333103,192.168.1.4,192.168.1.6,4061397981,1556773384,10926,1,770221
330,1576412377.333216,192.168.1.4,192.168.1.6,1428259339,1293278576,1385,1,771606
331,1576412377.349453,192.168.1.4,192.168.1.6,2370315923,4238289937,5474,1,777080
332,1576412377.349495,192.168.1.4,192.168.1.6,4061408907,1556773384,4344,1,781424
333,1576412377.349664,192.168.1.4,192.168.1.6,4061413251,1556773384,1130,1,782554
334,1576412377.350402,192.168.1.4,192.168.1.6,2370321397,4238289937,2748,1,785302
335,1576412377.357728,192.168.1.4,192.168.1.6,2370324145,4238289937,2748,1,788050
336,1576412377.366398,192.168.1.4,192.168.1.6,2370326893,4238289937,1385,1,789435
337,1576412377.368867,192.168.1.4,192.168.1.6,2370328278,4238289937,5474,1,794909
338,1576412377.369812,192.168.1.4,192.168.1.6,2370333752,4238289937,1385,1,796294
339,1576412377.373370,192.168.1.4,192.168.1.6,2370335137,4238289937,13652,1,809946
340,1576412377.374067,192.168.1.4,192.168.1.6,2370348789,4238289937,1385,1,811331
341,1576412377.379902,192.168.1.4,192.168.1.6,25632661,2910085316,1385,1,812716
342,1576412377.379979,192.168.1.4,192.168.1.6,2370350174,4238289937,1448,1,814164
343,1576412377.380290,192.168.1.4,192.168.1.6,2370351622,4238289937,10841,1,825005
344,1576412377.380297,192.168.1.4,192.168.1.6,3399181826,1038634852,1129,1,826134
345,1576412377.384611,192.168.1.6,192.168.1.4,1038634852,3399182955,53,0,826081
346,1576412377.384804,192.168.1.6,192.168.1.4,1038634905,3399182955,61,0,826020
347,1576412377.392357,192.168.1.4,192.168.1.6,2370362463,4238289937,16406,1,842426
348,1576412377.392656,192.168.1.4,192.168.1.6,2370378869,4238289937,2720,1,845146
349,1576412377.393172,192.168.1.4,192.168.1.6,2370381589,4238289937,4111,1,849257
350,1576412377.396967,192.168.1.4,192.168.1.6,642852104,2420492328,2070,1,851327
351,1576412377.397306,192.168.1.4,192.168.1.6,4163735605,997734843,2070,1,853397
352,1576412377.423167,192.168.1.4,192.168.1.6,25634046,2910085316,2588,1,855985
353,1576412377.439044,192.168.1.4,192.168.1.6,4163737675,997734843,4239,1,860224
354,1576412377.439094,192.168.1.4,192.168.1.6,642854174,2420492328,2778,1,863002
355,1576412377.494565,192.168.1.4,192.168.1.6,2370385700,4238289937,1385,1,864387
356,1576412377.495306,192.168.1.4,192.168.1.6,2370387085,4238289937,1385,1,865772
357,1576412377.510538,192.168.1.4,192.168.1.6,1428260724,1293278576,2070,1,867842
358,1576412377.514846,192.168.1.4,192.168.1.6,4061414381,1556773384,8200,1,876042
359,1576412377.529957,192.168.1.4,192.168.1.6,4061422581,1556773384,2070,1,878112
360,1576412377.530784,192.168.1.4,192.168.1.6,4061424651,1556773384,700,1,878812
361,1576412377.531064,192.168.1.4,192.168.1.6,4061425351,1556773384,2070,1,880882
362,1576412377.535335,192.168.1.4,192.168.1.6,2370388470,4238289937,16406,1,897288
363,1576412377.535745,192.168.1.4,192.168.1.6,2370404876,4238289937,10136,1,907424
364,1576412377.536111,192.168.1.4,192.168.1.6,2370415012,4238289937,7606,1,915030
365,1576412377.536479,192.168.1.4,192.168.1.6,2370422618,4238289937,1378,1,916408
366,1576412377.537169,192.168.1.4,192.168.1.6,2370423996,4238289937,2070,1,918478
367,1576412377.537329,192.168.1.4,192.168.1.6,2370426066,4238289937,700,1,919178
368,1576412377.539179,192.168.1.4,192.168.1.6,2370426766,4238289937,1385,1,920563
369,1576412377.542224,192.168.1.4,192.168.1.6,2370428151,4238289937,1385,1,921948
370,1576412377.550995,192.168.1.4,192.168.1.6,1428262794,1293278576,14330,1,936278
371,1576412377.576245,192.168.1.4,192.168.1.6,4061427421,1556773384,3426,1,939704
372,1576412377.583243,192.168.1.4,192.168.1.6,2370429536,4238289937,8200,1,947904
373,1576412377.666226,192.168.1.4,192.168.1.6,2370437736,4238289937,2070,1,949974
374,1576412377.666551,192.168.1.4,192.168.1.6,2370439806,4238289937,2063,1,952037
375,1576412377.686990,192.168.1.4,192.168.1.6,1428277124,1293278576,2070,1,954107
376,1576412377.687172,192.168.1.4,192.168.1.6,1428279194,1293278576,2070,1,956177
377,1576412377.687960,192.168.1.4,192.168.1.6,2370441869,4238289937,2070,1,958247
378,1576412377.688503,192.168.1.4,192.168.1.6,2370443939,4238289937,2070,1,960317
379,1576412377.690862,192.168.1.4,192.168.1.6,4061430847,1556773384,2070,1,962387
380,1576412377.690964,192.168.1.4,192.168.1.6,4061432917,1556773384,2070,1,964457
381,1576412377.714502,192.168.1.4,192.168.1.6,1428281264,1293278576,14480,1,978937
382,1576412377.714947,192.168.1.4,192.168.1.6,1428295744,1293278576,1926,1,980863
383,1576412377.715024,192.168.1.4,192.168.1.6,1428297670,1293278576,11584,1,992447
384,1576412377.715065,192.168.1.4,192.168.1.6,1428309254,1293278576,4822,1,997269
385,1576412377.715613,192.168.1.4,192.168.1.6,1428314076,1293278576,2014,1,999283
386,1576412377.715960,192.168.1.4,192.168.1.6,1428316090,1293278576,2070,1,1001353
387,1576412377.716272,192.168.1.4,192.168.1.6,1428318160,1293278576,2070,1,1003423
388,1576412377.732513,192.168.1.4,192.168.1.6,2370446009,4238289937,16406,1,1019829
389,1576412377.732669,192.168.1.4,192.168.1.6,2370462415,4238289937,13032,1,1032861
390,1576412377.734478,192.168.1.4,192.168.1.6,2370475447,4238289937,1948,1,1034809
391,1576412377.734567,192.168.1.4,192.168.1.6,4061434987,1556773384,3205,1,1038014
392,1576412377.763855,192.168.1.4,192.168.1.6,1428320230,1293278576,2049,1,1040063
393,1576412377.775126,192.168.1.4,192.168.1.6,2370477395,4238289937,9563,1,1049626
394,1576412377.836593,192.168.1.4,192.168.1.6,2370486958,4238289937,15015,1,1064641
395,1576412377.837306,192.168.1.4,192.168.1.6,2370501973,4238289937,2748,1,1067389
396,1576412377.841352,192.168.1.4,192.168.1.6,2370504721,4238289937,4111,1,1071500
397,1576412377.843175,192.168.1.4,192.168.1.6,2370508832,4238289937,1385,1,1072885
398,1576412377.855093,192.168.1.4,192.168.1.6,2370510217,4238289937,1385,1,1074270
399,1576412377.867997,192.168.1.4,192.168.1.6,1428322279,1293278576,1385,1,1075655
400,1576412377.868403,192.168.1.4,192.168.1.6,1428323664,1293278576,2070,1,1077725
401,1576412377.898755,192.168.1.4,192.168.1.6,2370511602,4238289937,8200,1,1085925
402,1576412377.910587,192.168.1.4,192.168.1.6,1428325734,1293278576,16406,1,1102331
403,1576412377.910835,192.168.1.4,192.168.1.6,1428342140,1293278576,12939,1,1115270
404,1576412377.943515,192.168.1.4,192.168.1.6,2370519802,4238289937,4285,1,1119555
405,1576412377.955014,192.168.1.4,192.168.1.6,1428355079,1293278576,16406,1,1135961
406,1576412377.955048,192.168.1.4,192.168.1.6,1428371485,1293278576,3262,1,1139223
407,1576412378.217803,192.168.1.4,192.168.1.6,1428374747,1293278576,4118,1,1143341
408,1576412378.230405,192.168.1.4,192.168.1.6,1428378865,1293278576,15928,1,1159269
409,1576412378.230719,192.168.1.4,192.168.1.6,1428394793,1293278576,14480,1,1173749
410,1576412378.230833,192.168.1.4,192.168.1.6,1428409273,1293278576,5089,1,1178838
411,1576412378.231090,192.168.1.4,192.168.1.6,1428414362,1293278576,2748,1,1181586
412,1576412378.238641,192.168.1.6,192.168.1.4,4238289937,2370524087,733,0,1180853
413,1576412378.245871,192.168.1.4,192.168.1.6,1428417110,1293278576,8200,1,1189053
414,1576412378.300916,192.168.1.4,192.168.1.6,1428425310,1293278576,2748,1,1191801
415,1576412378.303657,192.168.1.4,192.168.1.6,1428428058,1293278576,2835,1,1194636
416,1576412378.527503,192.168.1.4,192.168.1.6,2370524087,4238290670,1385,1,1196021
417,1576412378.531487,192.168.1.4,192.168.1.6,2370525472,4238290670,2896,1,1198917
418,1576412378.531680,192.168.1.4,192.168.1.6,2370528368,4238290670,2896,1,1201813
419,1576412378.531851,192.168.1.4,192.168.1.6,2370531264,4238290670,2408,1,1204221
420,1576412378.532249,192.168.1.4,192.168.1.6,2370533672,4238290670,1385,1,1205606
421,1576412378.532752,192.168.1.4,192.168.1.6,2370535057,4238290670,1385,1,1206991
422,1576412378.574495,192.168.1.4,192.168.1.6,2370536442,4238290670,7125,1,1214116
423,1576412378.618491,192.168.1.4,192.168.1.6,2370543567,4238290670,5474,1,1219590
424,1576412378.698348,192.168.1.4,192.168.1.6,2370549041,4238290670,9563,1,1229153
425,1576412378.737809,192.168.1.4,192.168.1.6,2370558604,4238290670,16406,1,1245559
426,1576412378.738106,192.168.1.4,192.168.1.6,2370575010,4238290670,4344,1,1249903
427,1576412378.747249,192.168.1.4,192.168.1.6,2370579354,4238290670,5792,1,1255695
428,1576412378.747563,192.168.1.4,192.168.1.6,2370585146,4238290670,7599,1,1263294
429,1576412378.778621,192.168.1.4,192.168.1.6,2370592745,4238290670,15015,1,1278309
430,1576412378.780164,192.168.1.4,192.168.1.6,2370607760,4238290670,2748,1,1281057
431,1576412378.787001,192.168.1.4,192.168.1.6,2370610508,4238290670,1385,1,1282442
432,1576412378.873027,192.168.1.4,192.168.1.6,2370611893,4238290670,16406,1,1298848
433,1576412378.873173,192.168.1.4,192.168.1.6,2370628299,4238290670,8172,1,1307020
434,1576412378.938777,192.168.1.4,192.168.1.6,2370636471,4238290670,1385,1,1308405
435,1576412378.985895,192.168.1.4,192.168.1.6,2370637856,4238290670,1385,1,1309790
436,1576412378.996259,192.168.1.4,192.168.1.6,2370639241,4238290670,16406,1,1326196
437,1576412378.996449,192.168.1.4,192.168.1.6,2370655647,4238290670,10136,1,1336332
438,1576412378.996660,192.168.1.4,192.168.1.6,2370665783,4238290670,8962,1,1345294
439,1576412378.998714,192.168.1.4,192.168.1.6,2370674745,4238290670,10926,1,1356220
440,1576412379.039971,192.168.1.4,192.168.1.6,2370685671,4238290670,13652,1,1369872
441,1576412379.042451,192.168.1.4,192.168.1.6,2370699323,4238290670,9563,1,1379435
442,1576412379.257503,192.168.1.4,192.168.1.6,2370708886,4238290670,4118,1,1383553
443,1576412379.272597,192.168.1.4,192.168.1.6,2370713004,4238290670,14480,1,1398033
444,1576412379.273279,192.168.1.4,192.168.1.6,2370727484,4238290670,1448,1,1399481
445,1576412379.273356,192.168.1.4,192.168.1.6,2370728932,4238290670,478,1,1399959
446,1576412379.273421,192.168.1.4,192.168.1.6,2370729410,4238290670,16406,1,1416365
447,1576412379.274020,192.168.1.4,192.168.1.6,2370745816,4238290670,16315,1,1432680
448,1576412379.275501,192.168.1.4,192.168.1.6,2370762131,4238290670,1385,1,1434065
449,1576412379.464788,192.168.1.4,192.168.1.6,2370763516,4238290670,2748,1,1436813
450,1576412379.480840,192.168.1.4,192.168.1.6,2370766264,4238290670,1385,1,1438198
451,1576412379.482693,192.168.1.4,192.168.1.6,2370767649,4238290670,5474,1,1443672
452,1576412379.483535,192.168.1.4,192.168.1.6,2370773123,4238290670,4111,1,1447783
453,1576412379.485257,192.168.1.4,192.168.1.6,2370777234,4238290670,1385,1,1449168
454,1576412379.486237,192.168.1.4,192.168.1.6,2370778619,4238290670,1385,1,1450553
455,1576412379.530038,192.168.1.4,192.168.1.6,2370780004,4238290670,16406,1,1466959
456,1576412379.530152,192.168.1.4,192.168.1.6,2370796410,4238290670,1357,1,1468316
457,1576412379.679856,192.168.1.4,192.168.1.6,2370797767,4238290670,13652,1,1481968
458,1576412379.682665,192.168.1.4,192.168.1.6,2370811419,4238290670,4111,1,1486079
459,1576412379.682788,192.168.1.4,192.168.1.6,2370815530,4238290670,2748,1,1488827
