index,time,src_ip,dst_ip,tcp_seq,tcp_ack,tcp_len,direction,cumul_sum
1,1576412634.310277,192.168.1.6,192.168.1.4,1674647906,199050693,343,0,-343
2,1576412634.311092,192.168.1.4,192.168.1.6,199050693,1674648249,99,1,-244
3,1576412634.311320,192.168.1.6,192.168.1.4,1674648249,199050792,382,0,-626
4,1576412634.323279,192.168.1.4,192.168.1.6,199050792,1674648631,2266,1,1640
5,1576412634.324133,192.168.1.6,192.168.1.4,1674648631,199053058,74,0,1566
6,1576412634.324244,192.168.1.6,192.168.1.4,1674648705,199053058,245,0,1321
7,1576412634.324584,192.168.1.4,192.168.1.6,199053058,1674648950,79,1,1400
8,1576412634.325090,192.168.1.4,192.168.1.6,199053137,1674648950,79,1,1479
9,1576412634.369432,192.168.1.4,192.168.1.6,199053216,1674648950,91,1,1570
10,1576412634.370574,192.168.1.6,192.168.1.4,1674648950,199053307,539,0,1031
11,1576412634.466805,192.168.1.4,192.168.1.6,199053307,1674649489,2070,1,3101
12,1576412634.502434,192.168.1.4,192.168.1.6,199055377,1674649489,1020,1,4121
13,1576412634.539882,192.168.1.6,192.168.1.4,1674649489,199056397,86,0,4035
14,1576412634.540324,192.168.1.6,192.168.1.4,1674649575,199056397,108,0,3927
15,1576412634.540876,192.168.1.6,192.168.1.4,1674649683,199056397,321,0,3606
16,1576412634.541092,192.168.1.6,192.168.1.4,1674650004,199056397,54,0,3552
17,1576412634.568490,192.168.1.4,192.168.1.6,199056397,1674650058,586,1,4138
18,1576412634.568924,192.168.1.6,192.168.1.4,1674650058,199056983,53,0,4085
19,1576412634.570937,192.168.1.4,192.168.1.6,199056983,1674650111,53,1,4138
20,1576412634.613878,192.168.1.4,192.168.1.6,199057036,1674650111,1344,1,5482
21,1576412634.616375,192.168.1.6,192.168.1.4,1674650111,199058380,61,0,5421
22,1576412634.881178,192.168.1.6,192.168.1.4,3757007431,2547838589,343,0,5078
23,1576412634.881765,192.168.1.4,192.168.1.6,2547838589,3757007774,99,1,5177
24,1576412634.881970,192.168.1.6,192.168.1.4,3757007774,2547838688,382,0,4795
25,1576412634.886363,192.168.1.6,192.168.1.4,1024757149,89039520,343,0,4452
26,1576412634.890694,192.168.1.4,192.168.1.6,89039520,1024757492,99,1,4551
27,1576412634.890941,192.168.1.6,192.168.1.4,1024757492,89039619,382,0,4169
28,1576412634.897336,192.168.1.4,192.168.1.6,2547838688,3757008156,2266,1,6435
29,1576412634.898189,192.168.1.6,192.168.1.4,3757008156,2547840954,74,0,6361
30,1576412634.898281,192.168.1.6,192.168.1.4,3757008230,2547840954,233,0,6128
31,1576412634.901918,192.168.1.4,192.168.1.6,2547840954,3757008463,79,1,6207
32,1576412634.902015,192.168.1.4,192.168.1.6,2547841033,3757008463,79,1,6286
33,1576412634.909247,192.168.1.4,192.168.1.6,89039619,1024757874,2266,1,8552
34,1576412634.911123,192.168.1.6,192.168.1.4,1024757874,89041885,74,0,8478
35,1576412634.911277,192.168.1.6,192.168.1.4,1024757948,89041885,233,0,8245
36,1576412634.911791,192.168.1.4,192.168.1.6,89041885,1024758181,79,1,8324
37,1576412634.912166,192.168.1.4,192.168.1.6,89041964,1024758181,79,1,8403
38,1576412635.484356,192.168.1.4,192.168.1.6,89042043,1024758181,91,1,8494
39,1576412635.485574,192.168.1.6,192.168.1.4,1024758181,89042134,539,0,7955
40,1576412635.487957,192.168.1.4,192.168.1.6,2547841112,3757008463,91,1,8046
41,1576412635.490230,192.168.1.6,192.168.1.4,3757008463,2547841203,539,0,7507
42,1576412635.791126,192.168.1.4,192.168.1.6,2547841203,3757009002,2070,1,9577
43,1576412635.791450,192.168.1.4,192.168.1.6,89042134,1024758720,2070,1,11647
44,1576412635.843321,192.168.1.4,192.168.1.6,2547843273,3757009002,1664,1,13311
45,1576412635.843370,192.168.1.4,192.168.1.6,89044204,1024758720,1664,1,14975
46,1576412635.845841,192.168.1.6,192.168.1.4,3757009002,2547844937,86,0,14889
47,1576412635.848489,192.168.1.6,192.168.1.4,1024758720,89045868,86,0,14803
48,1576412635.848922,192.168.1.6,192.168.1.4,3757009088,2547844937,546,0,14257
49,1576412637.275512,192.168.1.4,192.168.1.6,2547844937,3757009634,594,1,14851
50,1576412637.317685,192.168.1.4,192.168.1.6,2547845531,3757009634,12289,1,27140
51,1576412637.334579,192.168.1.4,192.168.1.6,2547857820,3757009634,1527,1,28667
52,1576412637.345992,192.168.1.4,192.168.1.6,2547859347,3757009634,1385,1,30052
53,1576412637.378717,192.168.1.4,192.168.1.6,2547860732,3757009634,1385,1,31437
54,1576412637.393560,192.168.1.6,192.168.1.4,1024758806,89045868,583,0,30854
55,1576412637.395559,192.168.1.6,192.168.1.4,2494450241,287267410,343,0,30511
56,1576412637.396133,192.168.1.4,192.168.1.6,287267410,2494450584,99,1,30610
57,1576412637.396355,192.168.1.6,192.168.1.4,2494450584,287267509,382,0,30228
58,1576412637.398346,192.168.1.6,192.168.1.4,289579849,3060905575,343,0,29885
59,1576412637.404906,192.168.1.4,192.168.1.6,3060905575,289580192,99,1,29984
60,1576412637.405183,192.168.1.6,192.168.1.4,289580192,3060905674,382,0,29602
61,1576412637.411848,192.168.1.4,192.168.1.6,287267509,2494450966,2266,1,31868
62,1576412637.412745,192.168.1.6,192.168.1.4,2494450966,287269775,74,0,31794
63,1576412637.412884,192.168.1.6,192.168.1.4,2494451040,287269775,233,0,31561
64,1576412637.416798,192.168.1.4,192.168.1.6,287269775,2494451273,79,1,31640
65,1576412637.416814,192.168.1.4,192.168.1.6,287269854,2494451273,79,1,31719
66,1576412637.421626,192.168.1.4,192.168.1.6,3060905674,289580574,2266,1,33985
67,1576412637.422548,192.168.1.6,192.168.1.4,289580574,3060907940,74,0,33911
68,1576412637.422651,192.168.1.6,192.168.1.4,289580648,3060907940,233,0,33678
69,1576412637.422933,192.168.1.4,192.168.1.6,3060907940,289580648,79,1,33757
70,1576412637.423038,192.168.1.4,192.168.1.6,3060908019,289580881,79,1,33836
71,1576412637.476330,192.168.1.4,192.168.1.6,2547862117,3757009634,4493,1,38329
72,1576412637.477640,192.168.1.6,192.168.1.4,3757009634,2547866610,603,0,37726
73,1576412637.560529,192.168.1.4,192.168.1.6,89045868,1024759389,1385,1,39111
74,1576412637.604775,192.168.1.4,192.168.1.6,89047253,1024759389,5792,1,44903
75,1576412637.604945,192.168.1.4,192.168.1.6,89053045,1024759389,8688,1,53591
76,1576412637.605441,192.168.1.4,192.168.1.6,89061733,1024759389,1587,1,55178
77,1576412637.663119,192.168.1.4,192.168.1.6,2547866610,3757010237,2070,1,57248
78,1576412637.704552,192.168.1.4,192.168.1.6,2547868680,3757010237,14548,1,71796
79,1576412637.758676,192.168.1.4,192.168.1.6,89063320,1024759389,5474,1,77270
80,1576412637.759028,192.168.1.4,192.168.1.6,89068794,1024759389,2748,1,80018
81,1576412637.782828,192.168.1.4,192.168.1.6,89071542,1024759389,8200,1,88218
82,1576412637.783876,192.168.1.4,192.168.1.6,3060908098,289580881,91,1,88309
83,1576412637.785631,192.168.1.4,192.168.1.6,287269933,2494451273,91,1,88400
84,1576412637.789140,192.168.1.6,192.168.1.4,289580881,3060908189,539,0,87861
85,1576412637.789438,192.168.1.6,192.168.1.4,2494451273,287270024,539,0,87322
86,1576412637.836029,192.168.1.4,192.168.1.6,2547883228,3757010237,6060,1,93382
87,1576412637.836746,192.168.1.6,192.168.1.4,3757010237,2547889288,572,0,92810
88,1576412637.844398,192.168.1.6,192.168.1.4,3438211406,1232088449,343,0,92467
89,1576412637.844987,192.168.1.4,192.168.1.6,1232088449,3438211749,99,1,92566
90,1576412637.845283,192.168.1.6,192.168.1.4,3438211749,1232088548,382,0,92184
91,1576412637.856168,192.168.1.4,192.168.1.6,1232088548,3438212131,2266,1,94450
92,1576412637.856996,192.168.1.6,192.168.1.4,3438212131,1232090814,74,0,94376
93,1576412637.857122,192.168.1.6,192.168.1.4,3438212205,1232090814,233,0,94143
94,1576412637.857409,192.168.1.4,192.168.1.6,1232090814,3438212438,79,1,94222
95,1576412637.857726,192.168.1.4,192.168.1.6,1232090893,3438212438,79,1,94301
96,1576412637.937072,192.168.1.4,192.168.1.6,89079742,1024759389,8200,1,102501
97,1576412637.952588,192.168.1.4,192.168.1.6,89087942,1024759389,1385,1,103886
98,1576412637.969446,192.168.1.4,192.168.1.6,89089327,1024759389,2070,1,105956
99,1576412637.986142,192.168.1.4,192.168.1.6,3060908189,289581420,2070,1,108026
100,1576412637.986384,192.168.1.4,192.168.1.6,287270024,2494451812,2070,1,110096
101,1576412638.013764,192.168.1.4,192.168.1.6,2547889288,3757010809,2070,1,112166
102,1576412638.013805,192.168.1.4,192.168.1.6,89091397,1024759389,4789,1,116955
103,1576412638.028593,192.168.1.4,192.168.1.6,287272094,2494451812,1664,1,118619
104,1576412638.028644,192.168.1.4,192.168.1.6,3060910259,289581420,1664,1,120283
105,1576412638.030243,192.168.1.6,192.168.1.4,2494451812,287273758,631,0,119652
106,1576412638.030309,192.168.1.6,192.168.1.4,289581420,3060911923,86,0,119566
107,1576412638.044730,192.168.1.4,192.168.1.6,1232090972,3438212438,91,1,119657
108,1576412638.045135,192.168.1.6,192.168.1.4,3438212438,1232091063,539,0,119118
109,1576412638.062007,192.168.1.4,192.168.1.6,2547891358,3757010809,14526,1,133644
110,1576412638.102931,192.168.1.4,192.168.1.6,89096186,1024759389,8200,1,141844
111,1576412638.154141,192.168.1.4,192.168.1.6,89104386,1024759389,8200,1,150044
112,1576412638.189040,192.168.1.4,192.168.1.6,2547905884,3757010809,2748,1,152792
113,1576412638.193832,192.168.1.4,192.168.1.6,2547908632,3757010809,2748,1,155540
114,1576412638.194872,192.168.1.4,192.168.1.6,2547911380,3757010809,2525,1,158065
115,1576412638.197872,192.168.1.6,192.168.1.4,3757010809,2547913905,498,0,157567
116,1576412638.215201,192.168.1.4,192.168.1.6,287273758,2494452443,1385,1,158952
117,1576412638.223277,192.168.1.4,192.168.1.6,1232091063,3438212977,2070,1,161022
118,1576412638.256152,192.168.1.4,192.168.1.6,287275143,2494452443,13032,1,174054
119,1576412638.256379,192.168.1.4,192.168.1.6,287288175,2494452443,3035,1,177089
120,1576412638.264697,192.168.1.4,192.168.1.6,1232093133,3438212977,1664,1,178753
121,1576412638.265893,192.168.1.6,192.168.1.4,3438212977,1232094797,86,0,178667
122,1576412638.274795,192.168.1.4,192.168.1.6,89112586,1024759389,13652,1,192319
123,1576412638.310841,192.168.1.4,192.168.1.6,89126238,1024759389,16406,1,208725
124,1576412638.311084,192.168.1.4,192.168.1.6,89142644,1024759389,11584,1,220309
125,1576412638.311103,192.168.1.4,192.168.1.6,89154228,1024759389,4822,1,225131
126,1576412638.311233,192.168.1.4,192.168.1.6,89159050,1024759389,9507,1,234638
127,1576412638.505182,192.168.1.4,192.168.1.6,2547913905,3757011307,2070,1,236708
128,1576412638.512426,192.168.1.4,192.168.1.6,287291210,2494452443,1385,1,238093
129,1576412638.530489,192.168.1.4,192.168.1.6,287292595,2494452443,1385,1,239478
130,1576412638.549489,192.168.1.4,192.168.1.6,2547915975,3757011307,14359,1,253837
131,1576412638.552671,192.168.1.4,192.168.1.6,287293980,2494452443,1385,1,255222
132,1576412638.571852,192.168.1.6,192.168.1.4,2046426117,671697340,343,0,254879
133,1576412638.572570,192.168.1.4,192.168.1.6,671697340,2046426460,99,1,254978
134,1576412638.572824,192.168.1.6,192.168.1.4,2046426460,671697439,382,0,254596
135,1576412638.585097,192.168.1.4,192.168.1.6,671697439,2046426842,2266,1,256862
136,1576412638.585692,192.168.1.4,192.168.1.6,287295365,2494452443,2896,1,259758
137,1576412638.585841,192.168.1.4,192.168.1.6,287298261,2494452443,2578,1,262336
138,1576412638.586269,192.168.1.6,192.168.1.4,2046426842,671699705,74,0,262262
139,1576412638.586452,192.168.1.6,192.168.1.4,2046426916,671699705,255,0,262007
140,1576412638.586890,192.168.1.4,192.168.1.6,287300839,2494452443,2748,1,264755
141,1576412638.587224,192.168.1.4,192.168.1.6,671699705,2046427171,79,1,264834
142,1576412638.587826,192.168.1.4,192.168.1.6,671699784,2046427171,79,1,264913
143,1576412638.591553,192.168.1.4,192.168.1.6,287303587,2494452443,2896,1,267809
144,1576412638.591743,192.168.1.4,192.168.1.6,287306483,2494452443,1215,1,269024
145,1576412638.592223,192.168.1.4,192.168.1.6,287307698,2494452443,1074,1,270098
146,1576412638.598391,192.168.1.4,192.168.1.6,89168557,1024759389,4118,1,274216
147,1576412638.640015,192.168.1.4,192.168.1.6,89172675,1024759389,6830,1,281046
148,1576412638.684432,192.168.1.4,192.168.1.6,89179505,1024759389,1385,1,282431
149,1576412638.728689,192.168.1.4,192.168.1.6,89180890,1024759389,1385,1,283816
150,1576412638.772589,192.168.1.4,192.168.1.6,89182275,1024759389,4111,1,287927
151,1576412638.815807,192.168.1.4,192.168.1.6,89186386,1024759389,1385,1,289312
152,1576412638.828455,192.168.1.4,192.168.1.6,89187771,1024759389,606,1,289918
153,1576412638.841396,192.168.1.4,192.168.1.6,671699863,2046427171,91,1,290009
154,1576412638.841737,192.168.1.6,192.168.1.4,2046427171,671699954,539,0,289470
155,1576412638.857858,192.168.1.4,192.168.1.6,287308772,2494452443,8688,1,298158
156,1576412638.858085,192.168.1.4,192.168.1.6,287317460,2494452443,5792,1,303950
157,1576412638.858345,192.168.1.4,192.168.1.6,287323252,2494452443,1926,1,305876
158,1576412638.881363,192.168.1.4,192.168.1.6,671699954,2046427710,2070,1,307946
159,1576412638.909716,192.168.1.6,192.168.1.4,1212923979,2291024674,343,0,307603
160,1576412638.910284,192.168.1.4,192.168.1.6,2291024674,1212924322,99,1,307702
161,1576412638.910569,192.168.1.6,192.168.1.4,1212924322,2291024773,382,0,307320
162,1576412638.933432,192.168.1.4,192.168.1.6,671702024,2046427710,1250,1,308570
163,1576412638.934672,192.168.1.4,192.168.1.6,2291024773,1212924704,2266,1,310836
164,1576412638.935583,192.168.1.6,192.168.1.4,1212924704,2291027039,74,0,310762
165,1576412638.935674,192.168.1.6,192.168.1.4,1212924778,2291027039,255,0,310507
166,1576412638.936055,192.168.1.4,192.168.1.6,2291027039,1212925033,79,1,310586
167,1576412638.936938,192.168.1.4,192.168.1.6,2291027118,1212925033,79,1,310665
168,1576412638.942646,192.168.1.6,192.168.1.4,2046427710,671703274,86,0,310579
169,1576412638.943074,192.168.1.6,192.168.1.4,2046427796,671703274,108,0,310471
170,1576412638.944422,192.168.1.6,192.168.1.4,2046427904,671703274,277,0,310194
171,1576412638.991221,192.168.1.6,192.168.1.4,1024759389,89188377,573,0,309621
172,1576412639.011172,192.168.1.6,192.168.1.4,3757011307,2547930334,599,0,309022
173,1576412639.013500,192.168.1.4,192.168.1.6,671703274,2046428181,617,1,309639
174,1576412639.014878,192.168.1.6,192.168.1.4,2046428181,671703891,53,0,309586
175,1576412639.015651,192.168.1.4,192.168.1.6,671703891,2046428234,7240,1,316826
176,1576412639.015957,192.168.1.4,192.168.1.6,671711131,2046428234,5489,1,322315
177,1576412639.019170,192.168.1.4,192.168.1.6,2291027197,1212925033,91,1,322406
178,1576412639.020149,192.168.1.6,192.168.1.4,1212925033,2291027288,539,0,321867
179,1576412639.042980,192.168.1.4,192.168.1.6,287325178,2494452443,2748,1,324615
180,1576412639.056201,192.168.1.4,192.168.1.6,671716620,2046428234,2748,1,327363
181,1576412639.066458,192.168.1.4,192.168.1.6,287327926,2494452443,1385,1,328748
182,1576412639.071476,192.168.1.4,192.168.1.6,287329311,2494452443,2070,1,330818
183,1576412639.112099,192.168.1.4,192.168.1.6,287331381,2494452443,10241,1,341059
184,1576412639.114360,192.168.1.4,192.168.1.6,671719368,2046428234,6854,1,347913
185,1576412639.115150,192.168.1.4,192.168.1.6,671726222,2046428234,1368,1,349281
186,1576412639.115366,192.168.1.4,192.168.1.6,2291027288,1212925572,2070,1,351351
187,1576412639.115959,192.168.1.4,192.168.1.6,671727590,2046428234,4009,1,355360
188,1576412639.117439,192.168.1.6,192.168.1.4,2046428234,671731599,61,0,355299
189,1576412639.155682,192.168.1.4,192.168.1.6,2291029358,1212925572,1250,1,356549
190,1576412639.157667,192.168.1.6,192.168.1.4,1212925572,2291030608,86,0,356463
191,1576412639.157887,192.168.1.6,192.168.1.4,1212925658,2291030608,108,0,356355
192,1576412639.158772,192.168.1.6,192.168.1.4,1212925766,2291030608,269,0,356086
193,1576412639.192199,192.168.1.4,192.168.1.6,89188377,1024759962,13652,1,369738
194,1576412639.192602,192.168.1.4,192.168.1.6,89202029,1024759962,2956,1,372694
195,1576412639.201443,192.168.1.4,192.168.1.6,89204985,1024759962,1385,1,374079
196,1576412639.216334,192.168.1.4,192.168.1.6,89206370,1024759962,2070,1,376149
197,1576412639.260027,192.168.1.4,192.168.1.6,89208440,1024759962,16406,1,392555
198,1576412639.260111,192.168.1.4,192.168.1.6,89224846,1024759962,6408,1,398963
199,1576412639.303603,192.168.1.4,192.168.1.6,89231254,1024759962,10926,1,409889
200,1576412639.314288,192.168.1.4,192.168.1.6,89242180,1024759962,5524,1,415413
201,1576412639.316743,192.168.1.4,192.168.1.6,89247704,1024759962,2748,1,418161
202,1576412639.324490,192.168.1.4,192.168.1.6,89250452,1024759962,2748,1,420909
203,1576412639.333774,192.168.1.4,192.168.1.6,89253200,1024759962,16406,1,437315
204,1576412639.334006,192.168.1.4,192.168.1.6,89269606,1024759962,5844,1,443159
205,1576412639.335151,192.168.1.4,192.168.1.6,89275450,1024759962,2311,1,445470
206,1576412639.336157,192.168.1.4,192.168.1.6,287341622,2494452443,1385,1,446855
207,1576412639.336292,192.168.1.4,192.168.1.6,2547930334,3757011906,1096,1,447951
208,1576412639.338201,192.168.1.4,192.168.1.6,287343007,2494452443,6166,1,454117
209,1576412639.338243,192.168.1.4,192.168.1.6,2291030608,1212926035,586,1,454703
210,1576412639.349241,192.168.1.6,192.168.1.4,1212926035,2291031194,53,0,454650
211,1576412639.350059,192.168.1.4,192.168.1.6,2291031194,1212926088,7240,1,461890
212,1576412639.350259,192.168.1.4,192.168.1.6,2291038434,1212926088,7240,1,469130
213,1576412639.350601,192.168.1.4,192.168.1.6,2291045674,1212926088,1926,1,471056
214,1576412639.350612,192.168.1.4,192.168.1.6,2291047600,1212926088,482,1,471538
215,1576412639.379896,192.168.1.4,192.168.1.6,287349173,2494452443,8871,1,480409
216,1576412639.391665,192.168.1.4,192.168.1.6,2291048082,1212926088,1755,1,482164
217,1576412639.397743,192.168.1.6,192.168.1.4,1212926088,2291049837,61,0,482103
218,1576412639.409785,192.168.1.4,192.168.1.6,89277761,1024759962,6837,1,488940
219,1576412639.413723,192.168.1.4,192.168.1.6,89284598,1024759962,8200,1,497140
220,1576412639.414801,192.168.1.4,192.168.1.6,89292798,1024759962,2748,1,499888
221,1576412639.418891,192.168.1.4,192.168.1.6,89295546,1024759962,2748,1,502636
222,1576412639.424197,192.168.1.4,192.168.1.6,89298294,1024759962,16406,1,519042
223,1576412639.424313,192.168.1.4,192.168.1.6,89314700,1024759962,2098,1,521140
224,1576412639.426013,192.168.1.4,192.168.1.6,89316798,1024759962,2007,1,523147
225,1576412639.426097,192.168.1.4,192.168.1.6,89318805,1024759962,15015,1,538162
226,1576412639.430881,192.168.1.6,192.168.1.4,3757011906,2547931430,675,0,537487
227,1576412639.447109,192.168.1.4,192.168.1.6,89333820,1024759962,5474,1,542961
228,1576412639.454867,192.168.1.4,192.168.1.6,89339294,1024759962,10926,1,553887
229,1576412639.478599,192.168.1.4,192.168.1.6,89350220,1024759962,1385,1,555272
230,1576412639.479811,192.168.1.4,192.168.1.6,89351605,1024759962,2748,1,558020
231,1576412639.487916,192.168.1.4,192.168.1.6,89354353,1024759962,4111,1,562131
232,1576412639.526287,192.168.1.4,192.168.1.6,287358044,2494452443,1385,1,563516
233,1576412639.526391,192.168.1.4,192.168.1.6,89358464,1024759962,3549,1,567065
234,1576412639.530059,192.168.1.4,192.168.1.6,287359429,2494452443,2748,1,569813
235,1576412639.535260,192.168.1.4,192.168.1.6,287362177,2494452443,5474,1,575287
236,1576412639.536184,192.168.1.4,192.168.1.6,287367651,2494452443,2748,1,578035
237,1576412639.553742,192.168.1.4,192.168.1.6,287370399,2494452443,4111,1,582146
238,1576412639.598913,192.168.1.6,192.168.1.4,1212926149,2291049837,375,0,581771
239,1576412639.629082,192.168.1.4,192.168.1.6,2547931430,3757012581,6166,1,587937
240,1576412639.658868,192.168.1.4,192.168.1.6,2291049837,1212926524,344,1,588281
241,1576412639.663731,192.168.1.6,192.168.1.4,1212926524,2291050181,57,0,588224
242,1576412639.665955,192.168.1.4,192.168.1.6,2291050181,1212926581,538,1,588762
243,1576412639.666912,192.168.1.6,192.168.1.4,4170966388,742098371,343,0,588419
244,1576412639.667581,192.168.1.4,192.168.1.6,742098371,4170966731,99,1,588518
245,1576412639.668045,192.168.1.6,192.168.1.4,4170966731,742098470,382,0,588136
246,1576412639.668540,192.168.1.6,192.168.1.4,1212926581,2291050719,61,0,588075
247,1576412639.671425,192.168.1.4,192.168.1.6,2547937596,3757012581,5792,1,593867
248,1576412639.671556,192.168.1.4,192.168.1.6,2547943388,3757012581,5792,1,599659
249,1576412639.671678,192.168.1.4,192.168.1.6,2547949180,3757012581,2896,1,602555
250,1576412639.671698,192.168.1.4,192.168.1.6,2547952076,3757012581,1926,1,604481
251,1576412639.672202,192.168.1.4,192.168.1.6,2547954002,3757012581,905,1,605386
252,1576412639.679748,192.168.1.4,192.168.1.6,742098470,4170967113,2266,1,607652
253,1576412639.680644,192.168.1.6,192.168.1.4,4170967113,742100736,74,0,607578
254,1576412639.680830,192.168.1.6,192.168.1.4,4170967187,742100736,253,0,607325
255,1576412639.681076,192.168.1.4,192.168.1.6,742100736,4170967440,79,1,607404
256,1576412639.681221,192.168.1.4,192.168.1.6,742100815,4170967440,79,1,607483
257,1576412639.774085,192.168.1.4,192.168.1.6,287374510,2494452443,5474,1,612957
258,1576412639.775338,192.168.1.4,192.168.1.6,287379984,2494452443,2070,1,615027
259,1576412639.788981,192.168.1.4,192.168.1.6,287382054,2494452443,7240,1,622267
260,1576412639.789150,192.168.1.4,192.168.1.6,287389294,2494452443,7240,1,629507
261,1576412639.789345,192.168.1.4,192.168.1.6,287396534,2494452443,13032,1,642539
262,1576412639.789406,192.168.1.4,192.168.1.6,287409566,2494452443,5944,1,648483
263,1576412639.806751,192.168.1.4,192.168.1.6,287415510,2494452443,5474,1,653957
264,1576412639.807548,192.168.1.4,192.168.1.6,287420984,2494452443,1385,1,655342
265,1576412639.810715,192.168.1.4,192.168.1.6,287422369,2494452443,5393,1,660735
266,1576412639.811899,192.168.1.4,192.168.1.6,287427762,2494452443,2748,1,663483
267,1576412639.815816,192.168.1.4,192.168.1.6,2547954907,3757012581,6837,1,670320
268,1576412639.815894,192.168.1.4,192.168.1.6,287430510,2494452443,1385,1,671705
269,1576412639.821717,192.168.1.4,192.168.1.6,742100894,4170967440,91,1,671796
270,1576412639.822103,192.168.1.6,192.168.1.4,4170967440,742100985,539,0,671257
271,1576412639.832094,192.168.1.4,192.168.1.6,2547961744,3757012581,11584,1,682841
272,1576412639.832306,192.168.1.4,192.168.1.6,2547973328,3757012581,2068,1,684909
273,1576412639.842404,192.168.1.4,192.168.1.6,2547975396,3757012581,6837,1,691746
274,1576412639.849189,192.168.1.4,192.168.1.6,742100985,4170967979,1385,1,693131
275,1576412639.891671,192.168.1.4,192.168.1.6,742102370,4170967979,1530,1,694661
276,1576412639.899542,192.168.1.6,192.168.1.4,4170967979,742103900,86,0,694575
277,1576412639.901680,192.168.1.6,192.168.1.4,4170968065,742103900,108,0,694467
278,1576412639.905882,192.168.1.6,192.168.1.4,4170968173,742103900,394,0,694073
279,1576412639.925226,192.168.1.4,192.168.1.6,742103900,4170968567,586,1,694659
280,1576412639.926153,192.168.1.6,192.168.1.4,4170968567,742104486,53,0,694606
281,1576412639.928649,192.168.1.4,192.168.1.6,742104486,4170968620,53,1,694659
282,1576412639.946928,192.168.1.4,192.168.1.6,287431895,2494452443,2748,1,697407
283,1576412639.949825,192.168.1.4,192.168.1.6,287434643,2494452443,10136,1,707543
284,1576412639.950217,192.168.1.4,192.168.1.6,287444779,2494452443,790,1,708333
285,1576412639.972107,192.168.1.4,192.168.1.6,742104539,4170968620,534,1,708867
286,1576412639.973254,192.168.1.4,192.168.1.6,287445569,2494452443,1385,1,710252
287,1576412639.982062,192.168.1.6,192.168.1.4,4170968620,742105073,61,0,710191
288,1576412640.009244,192.168.1.4,192.168.1.6,287446954,2494452443,16378,1,726569
289,1576412640.020417,192.168.1.4,192.168.1.6,287463332,2494452443,8688,1,735257
290,1576412640.021118,192.168.1.4,192.168.1.6,287472020,2494452443,4964,1,740221
291,1576412640.060481,192.168.1.4,192.168.1.6,287476984,2494452443,1385,1,741606
292,1576412640.098834,192.168.1.4,192.168.1.6,287478369,2494452443,5474,1,747080
293,1576412640.102545,192.168.1.4,192.168.1.6,287483843,2494452443,9563,1,756643
294,1576412640.115352,192.168.1.4,192.168.1.6,2547982233,3757012581,4118,1,760761
295,1576412640.115467,192.168.1.4,192.168.1.6,287493406,2494452443,4344,1,765105
296,1576412640.115761,192.168.1.4,192.168.1.6,287497750,2494452443,12062,1,777167
297,1576412640.116180,192.168.1.4,192.168.1.6,287509812,2494452443,3405,1,780572
298,1576412640.116221,192.168.1.4,192.168.1.6,287513217,2494452443,700,1,781272
299,1576412640.119210,192.168.1.4,192.168.1.6,287513917,2494452443,14480,1,795752
300,1576412640.120136,192.168.1.4,192.168.1.6,287528397,2494452443,535,1,796287
301,1576412640.120175,192.168.1.4,192.168.1.6,287528932,2494452443,2748,1,799035
302,1576412640.131726,192.168.1.4,192.168.1.6,287531680,2494452443,2748,1,801783
303,1576412640.135050,192.168.1.4,192.168.1.6,287534428,2494452443,1385,1,803168
304,1576412640.155414,192.168.1.4,192.168.1.6,2547986351,3757012581,2653,1,805821
305,1576412640.204520,192.168.1.4,192.168.1.6,287535813,2494452443,5465,1,811286
306,1576412640.205539,192.168.1.4,192.168.1.6,287541278,2494452443,2748,1,814034
307,1576412640.286650,192.168.1.4,192.168.1.6,287544026,2494452443,9563,1,823597
308,1576412640.302394,192.168.1.4,192.168.1.6,287553589,2494452443,6765,1,830362
309,1576412640.303284,192.168.1.4,192.168.1.6,287560354,2494452443,2748,1,833110
310,1576412640.306841,192.168.1.4,192.168.1.6,287563102,2494452443,13652,1,846762
311,1576412640.307637,192.168.1.4,192.168.1.6,287576754,2494452443,4111,1,850873
312,1576412640.325121,192.168.1.4,192.168.1.6,287580865,2494452443,13652,1,864525
313,1576412640.325700,192.168.1.4,192.168.1.6,287594517,2494452443,4111,1,868636
314,1576412640.340110,192.168.1.4,192.168.1.6,287598628,2494452443,5474,1,874110
315,1576412640.340202,192.168.1.4,192.168.1.6,287604102,2494452443,2748,1,876858
316,1576412640.437474,192.168.1.4,192.168.1.6,287606850,2494452443,15015,1,891873
317,1576412640.437635,192.168.1.4,192.168.1.6,287621865,2494452443,2748,1,894621
318,1576412640.440676,192.168.1.4,192.168.1.6,287624613,2494452443,13652,1,908273
319,1576412640.441471,192.168.1.4,192.168.1.6,287638265,2494452443,4111,1,912384
320,1576412640.466703,192.168.1.4,192.168.1.6,287642376,2494452443,12289,1,924673
321,1576412640.493190,192.168.1.4,192.168.1.6,287654665,2494452443,1385,1,926058
322,1576412640.496583,192.168.1.4,192.168.1.6,287656050,2494452443,1385,1,927443
323,1576412640.505202,192.168.1.4,192.168.1.6,287657435,2494452443,16406,1,943849
324,1576412640.505968,192.168.1.4,192.168.1.6,287673841,2494452443,16406,1,960255
325,1576412640.506326,192.168.1.4,192.168.1.6,287690247,2494452443,11584,1,971839
326,1576412640.507253,192.168.1.4,192.168.1.6,287701831,2494452443,2927,1,974766
327,1576412640.507974,192.168.1.4,192.168.1.6,287704758,2494452443,8460,1,983226
328,1576412640.902521,192.168.1.6,192.168.1.4,2494452443,287713218,733,0,982493
329,1576412641.006015,192.168.1.6,192.168.1.4,3757012581,2547989004,731,0,981762
330,1576412641.077317,192.168.1.4,192.168.1.6,287713218,2494453176,1084,1,982846
331,1576412641.193134,192.168.1.4,192.168.1.6,2547989004,3757013312,7240,1,990086
332,1576412641.193682,192.168.1.4,192.168.1.6,2547996244,3757013312,7240,1,997326
333,1576412641.193751,192.168.1.4,192.168.1.6,2548003484,3757013312,2138,1,999464
334,1576412641.217826,192.168.1.4,192.168.1.6,2548005622,3757013312,8214,1,1007678
335,1576412641.258669,192.168.1.4,192.168.1.6,2548013836,3757013312,1371,1,1009049
336,1576412641.528636,192.168.1.4,192.168.1.6,2548015207,3757013312,12289,1,1021338
337,1576412641.562614,192.168.1.4,192.168.1.6,2548027496,3757013312,10926,1,1032264
338,1576412641.721065,192.168.1.4,192.168.1.6,2548038422,3757013312,10262,1,1042526
339,1576412641.762397,192.168.1.4,192.168.1.6,2548048684,3757013312,16406,1,1058932
340,1576412641.762460,192.168.1.4,192.168.1.6,2548065090,3757013312,658,1,1059590
341,1576412641.823436,192.168.1.6,192.168.1.4,1249616824,4005207983,343,0,1059247
342,1576412641.824140,192.168.1.4,192.168.1.6,4005207983,1249617167,99,1,1059346
343,1576412641.824385,192.168.1.6,192.168.1.4,1249617167,4005208082,382,0,1058964
344,1576412641.835225,192.168.1.4,192.168.1.6,4005208082,1249617549,2266,1,1061230
345,1576412641.836166,192.168.1.6,192.168.1.4,1249617549,4005210348,74,0,1061156
346,1576412641.836259,192.168.1.6,192.168.1.4,1249617623,4005210348,237,0,1060919
347,1576412641.836557,192.168.1.4,192.168.1.6,4005210348,1249617860,79,1,1060998
348,1576412641.836693,192.168.1.4,192.168.1.6,4005210427,1249617860,79,1,1061077
349,1576412641.963844,192.168.1.4,192.168.1.6,2548065748,3757013312,16378,1,1077455
350,1576412641.968947,192.168.1.4,192.168.1.6,4005210506,1249617860,91,1,1077546
351,1576412641.970635,192.168.1.6,192.168.1.4,1249617860,4005210597,539,0,1077007
352,1576412642.037487,192.168.1.4,192.168.1.6,2548082126,3757013312,1385,1,1078392
353,1576412642.040122,192.168.1.4,192.168.1.6,2548083511,3757013312,13032,1,1091424
354,1576412642.040423,192.168.1.4,192.168.1.6,2548096543,3757013312,1448,1,1092872
355,1576412642.040546,192.168.1.4,192.168.1.6,2548097991,3757013312,535,1,1093407
356,1576412642.041087,192.168.1.4,192.168.1.6,2548098526,3757013312,2748,1,1096155
357,1576412642.042890,192.168.1.4,192.168.1.6,2548101274,3757013312,1385,1,1097540
358,1576412642.043398,192.168.1.4,192.168.1.6,4005210597,1249618399,2070,1,1099610
359,1576412642.086358,192.168.1.4,192.168.1.6,4005212667,1249618399,1754,1,1101364
360,1576412642.090816,192.168.1.6,192.168.1.4,1249618399,4005214421,86,0,1101278
361,1576412642.091046,192.168.1.6,192.168.1.4,1249618485,4005214421,108,0,1101170
362,1576412642.091388,192.168.1.6,192.168.1.4,1249618593,4005214421,279,0,1100891
363,1576412642.136218,192.168.1.4,192.168.1.6,4005214421,1249618872,586,1,1101477
364,1576412642.137018,192.168.1.6,192.168.1.4,1249618872,4005215007,53,0,1101424
365,1576412642.145265,192.168.1.4,192.168.1.6,4005215007,1249618925,1752,1,1103176
366,1576412642.169753,192.168.1.4,192.168.1.6,2548102659,3757013312,6837,1,1110013
367,1576412642.175672,192.168.1.4,192.168.1.6,2548109496,3757013312,4111,1,1114124
368,1576412642.177030,192.168.1.4,192.168.1.6,2548113607,3757013312,2748,1,1116872
369,1576412642.180393,192.168.1.4,192.168.1.6,2548116355,3757013312,5474,1,1122346
370,1576412642.181586,192.168.1.4,192.168.1.6,2548121829,3757013312,2748,1,1125094
371,1576412642.186665,192.168.1.4,192.168.1.6,4005216759,1249618925,1158,1,1126252
372,1576412642.187889,192.168.1.6,192.168.1.4,1249618925,4005217917,61,0,1126191
373,1576412642.204474,192.168.1.4,192.168.1.6,2548124577,3757013312,1385,1,1127576
374,1576412642.233199,192.168.1.4,192.168.1.6,2548125962,3757013312,16406,1,1143982
375,1576412642.233251,192.168.1.4,192.168.1.6,2548142368,3757013312,2720,1,1146702
376,1576412642.237917,192.168.1.4,192.168.1.6,2548143816,3757013312,1272,1,1147974
377,1576412642.238001,192.168.1.4,192.168.1.6,2548145088,3757013312,4111,1,1152085
378,1576412642.264468,192.168.1.4,192.168.1.6,2548149199,3757013312,16378,1,1168463
379,1576412642.376592,192.168.1.4,192.168.1.6,2548165577,3757013312,6837,1,1175300
380,1576412642.377513,192.168.1.4,192.168.1.6,2548172414,3757013312,2748,1,1178048
381,1576412642.469956,192.168.1.4,192.168.1.6,2548175162,3757013312,1385,1,1179433
382,1576412642.475808,192.168.1.4,192.168.1.6,2548176547,3757013312,12802,1,1192235
383,1576412642.476787,192.168.1.4,192.168.1.6,2548189349,3757013312,4961,1,1197196
384,1576412642.478986,192.168.1.4,192.168.1.6,2548194310,3757013312,10926,1,1208122
385,1576412642.479771,192.168.1.4,192.168.1.6,2548205236,3757013312,1385,1,1209507
386,1576412642.484392,192.168.1.4,192.168.1.6,2548206621,3757013312,1385,1,1210892
387,1576412642.526485,192.168.1.4,192.168.1.6,2548208006,3757013312,4111,1,1215003
388,1576412642.570539,192.168.1.4,192.168.1.6,2548212117,3757013312,16406,1,1231409
389,1576412642.570743,192.168.1.4,192.168.1.6,2548228523,3757013312,6809,1,1238218
390,1576412642.615611,192.168.1.4,192.168.1.6,2548235332,3757013312,2748,1,1240966
391,1576412642.619802,192.168.1.4,192.168.1.6,2548238080,3757013312,10926,1,1251892
392,1576412642.645341,192.168.1.4,192.168.1.6,2548249006,3757013312,14480,1,1266372
393,1576412642.645660,192.168.1.4,192.168.1.6,2548263486,3757013312,1926,1,1268298
394,1576412642.645718,192.168.1.4,192.168.1.6,2548265412,3757013312,1357,1,1269655
395,1576412642.647176,192.168.1.4,192.168.1.6,2548266769,3757013312,5010,1,1274665
396,1576412642.654153,192.168.1.4,192.168.1.6,2548271779,3757013312,2748,1,1277413
397,1576412642.655157,192.168.1.4,192.168.1.6,2548274527,3757013312,1385,1,1278798
398,1576412642.896948,192.168.1.4,192.168.1.6,2548275912,3757013312,4118,1,1282916
399,1576412642.938638,192.168.1.4,192.168.1.6,2548280030,3757013312,14480,1,1297396
400,1576412642.939319,192.168.1.4,192.168.1.6,2548294510,3757013312,12817,1,1310213
401,1576412643.109418,192.168.1.4,192.168.1.6,2548307327,3757013312,6963,1,1317176
