index,time,src_ip,dst_ip,tcp_seq,tcp_ack,tcp_len,direction,cumul_sum
1,1574590013.528292,192.168.1.4,192.168.1.5,3552061900,2792134030,91,1,91
2,1574590013.52834,192.168.1.4,192.168.1.5,3552061991,2792134030,24,1,115
3,1574590017.960137,192.168.1.5,192.168.1.4,229672253,4271802967,343,0,-228
4,1574590017.96088,192.168.1.4,192.168.1.5,4271802967,229672596,99,1,-129
5,1574590017.961458,192.168.1.5,192.168.1.4,229672596,4271803066,382,0,-511
6,1574590017.975156,192.168.1.4,192.168.1.5,4271803066,229672978,2266,1,1755
7,1574590017.976054,192.168.1.5,192.168.1.4,229672978,4271805332,74,0,1681
8,1574590017.976198,192.168.1.5,192.168.1.4,229673052,4271805332,245,0,1436
9,1574590017.976483,192.168.1.4,192.168.1.5,4271805332,229673297,79,1,1515
10,1574590017.977122,192.168.1.4,192.168.1.5,4271805411,229673297,79,1,1594
11,1574590018.124875,192.168.1.5,192.168.1.4,462940904,4075088359,343,0,1251
12,1574590018.12528,192.168.1.4,192.168.1.5,4075088359,462941247,99,1,1350
13,1574590018.125618,192.168.1.5,192.168.1.4,462941247,4075088458,382,0,968
14,1574590018.127356,192.168.1.5,192.168.1.4,2363859832,1269130278,343,0,625
15,1574590018.130716,192.168.1.4,192.168.1.5,1269130278,2363860175,99,1,724
16,1574590018.131007,192.168.1.5,192.168.1.4,2363860175,1269130377,382,0,342
17,1574590018.141849,192.168.1.4,192.168.1.5,4075088458,462941629,2266,1,2608
18,1574590018.14269,192.168.1.5,192.168.1.4,462941629,4075090724,74,0,2534
19,1574590018.142801,192.168.1.5,192.168.1.4,462941703,4075090724,227,0,2307
20,1574590018.145974,192.168.1.4,192.168.1.5,1269130377,2363860557,2266,1,4573
21,1574590018.146071,192.168.1.4,192.168.1.5,4075090724,462941930,79,1,4652
22,1574590018.146164,192.168.1.4,192.168.1.5,4075090803,462941930,79,1,4731
23,1574590018.147146,192.168.1.5,192.168.1.4,2363860557,1269132643,74,0,4657
24,1574590018.147276,192.168.1.5,192.168.1.4,2363860631,1269132643,227,0,4430
25,1574590018.147523,192.168.1.4,192.168.1.5,1269132643,2363860631,79,1,4509
26,1574590018.148362,192.168.1.4,192.168.1.5,1269132722,2363860858,79,1,4588
27,1574590019.62632,192.168.1.4,192.168.1.5,4271805490,229673297,91,1,4679
28,1574590019.627545,192.168.1.5,192.168.1.4,229673297,4271805581,539,0,4140
29,1574590019.673974,192.168.1.4,192.168.1.5,4271805581,229673836,2070,1,6210
30,1574590019.71451,192.168.1.4,192.168.1.5,4271807651,229673836,1018,1,7228
31,1574590019.721052,192.168.1.5,192.168.1.4,229673836,4271808669,86,0,7142
32,1574590019.721793,192.168.1.5,192.168.1.4,229673922,4271808669,108,0,7034
33,1574590019.722269,192.168.1.5,192.168.1.4,229674030,4271808669,321,0,6713
34,1574590019.722476,192.168.1.5,192.168.1.4,229674351,4271808669,54,0,6659
35,1574590019.758136,192.168.1.4,192.168.1.5,4271808669,229674405,617,1,7276
36,1574590019.758749,192.168.1.5,192.168.1.4,229674405,4271809286,53,0,7223
37,1574590019.767325,192.168.1.4,192.168.1.5,4271809286,229674458,1310,1,8533
38,1574590019.770055,192.168.1.5,192.168.1.4,229674458,4271810596,61,0,8472
39,1574590019.848716,192.168.1.4,192.168.1.5,1269132801,2363860858,91,1,8563
40,1574590019.849337,192.168.1.5,192.168.1.4,2363860858,1269132892,539,0,8024
41,1574590019.849483,192.168.1.4,192.168.1.5,4075090882,462941930,91,1,8115
42,1574590019.850052,192.168.1.5,192.168.1.4,462941930,4075090973,539,0,7576
43,1574590019.89024,192.168.1.4,192.168.1.5,1269132892,2363861397,2070,1,9646
44,1574590019.890364,192.168.1.4,192.168.1.5,4075090973,462942469,2070,1,11716
45,1574590019.930513,192.168.1.4,192.168.1.5,1269134962,2363861397,1757,1,13473
46,1574590019.934153,192.168.1.4,192.168.1.5,4075093043,462942469,1756,1,15229
47,1574590019.934609,192.168.1.5,192.168.1.4,2363861397,1269136719,86,0,15143
48,1574590019.936076,192.168.1.5,192.168.1.4,462942469,4075094799,86,0,15057
49,1574590019.936273,192.168.1.5,192.168.1.4,2363861483,1269136719,108,0,14949
50,1574590019.936689,192.168.1.5,192.168.1.4,2363861591,1269136719,369,0,14580
51,1574590019.967943,192.168.1.4,192.168.1.5,1269136719,2363861960,586,1,15166
52,1574590019.968284,192.168.1.5,192.168.1.4,2363861960,1269137305,53,0,15113
53,1574590019.988309,192.168.1.4,192.168.1.5,4075094799,462942555,586,1,15699
54,1574590019.988418,192.168.1.4,192.168.1.5,1269137305,2363862013,742,1,16441
55,1574590019.989459,192.168.1.5,192.168.1.4,2363862013,1269138047,57,0,16384
56,1574590019.989585,192.168.1.5,192.168.1.4,2363862070,1269138047,61,0,16323
57,1574590019.995914,192.168.1.5,192.168.1.4,1142673835,1395123932,343,0,15980
58,1574590019.996344,192.168.1.4,192.168.1.5,1395123932,1142674178,99,1,16079
59,1574590019.997048,192.168.1.5,192.168.1.4,1142674178,1395124031,382,0,15697
60,1574590020.015628,192.168.1.4,192.168.1.5,1395124031,1142674560,2266,1,17963
61,1574590020.017075,192.168.1.5,192.168.1.4,1142674560,1395126297,74,0,17889
62,1574590020.017342,192.168.1.5,192.168.1.4,1142674634,1395126297,235,0,17654
63,1574590020.017789,192.168.1.4,192.168.1.5,1395126297,1142674869,79,1,17733
64,1574590020.017879,192.168.1.4,192.168.1.5,1395126376,1142674869,79,1,17812
65,1574590021.03881,192.168.1.4,192.168.1.5,1395126455,1142674869,91,1,17903
66,1574590021.039541,192.168.1.5,192.168.1.4,1142674869,1395126546,539,0,17364
67,1574590021.084562,192.168.1.4,192.168.1.5,1395126546,1142675408,2070,1,19434
68,1574590021.126579,192.168.1.4,192.168.1.5,1395128616,1142675408,599,1,20033
69,1574590021.129851,192.168.1.5,192.168.1.4,1142675408,1395129215,86,0,19947
70,1574590021.130215,192.168.1.5,192.168.1.4,1142675494,1395129215,108,0,19839
71,1574590021.130708,192.168.1.5,192.168.1.4,1142675602,1395129215,373,0,19466
72,1574590021.165691,192.168.1.4,192.168.1.5,1395129215,1142675975,617,1,20083
73,1574590021.166377,192.168.1.5,192.168.1.4,1142675975,1395129832,53,0,20030
74,1574590021.176496,192.168.1.4,192.168.1.5,1395129832,1142676028,2070,1,22100
75,1574590021.218573,192.168.1.4,192.168.1.5,1395131902,1142676028,13254,1,35354
76,1574590021.219502,192.168.1.5,192.168.1.4,1142676028,1395145156,61,0,35293
77,1574590021.232976,192.168.1.5,192.168.1.4,2345991883,4290416227,343,0,34950
78,1574590021.233331,192.168.1.4,192.168.1.5,4290416227,2345992226,99,1,35049
79,1574590021.233797,192.168.1.5,192.168.1.4,2345992226,4290416326,382,0,34667
80,1574590021.236249,192.168.1.5,192.168.1.4,2714418321,2657761640,343,0,34324
81,1574590021.238733,192.168.1.4,192.168.1.5,2657761640,2714418664,99,1,34423
82,1574590021.239086,192.168.1.5,192.168.1.4,2714418664,2657761739,382,0,34041
83,1574590021.239348,192.168.1.5,192.168.1.4,1142676089,1395145156,149,0,33892
84,1574590021.242411,192.168.1.5,192.168.1.4,1142676238,1395145156,121,0,33771
85,1574590021.245253,192.168.1.5,192.168.1.4,3999380796,1802306218,343,0,33428
86,1574590021.247756,192.168.1.5,192.168.1.4,3029926420,1042360986,343,0,33085
87,1574590021.250693,192.168.1.4,192.168.1.5,1802306218,3999381139,99,1,33184
88,1574590021.251047,192.168.1.5,192.168.1.4,3999381139,1802306317,382,0,32802
89,1574590021.251293,192.168.1.4,192.168.1.5,1042360986,3029926763,99,1,32901
90,1574590021.251574,192.168.1.5,192.168.1.4,3029926763,1042361085,382,0,32519
91,1574590021.278293,192.168.1.4,192.168.1.5,1395145156,1142676359,2070,1,34589
92,1574590021.285753,192.168.1.4,192.168.1.5,4290416326,2345992608,2266,1,36855
93,1574590021.287142,192.168.1.5,192.168.1.4,2345992608,4290418592,74,0,36781
94,1574590021.287514,192.168.1.5,192.168.1.4,2345992682,4290418592,247,0,36534
95,1574590021.287932,192.168.1.4,192.168.1.5,4290418592,2345992929,79,1,36613
96,1574590021.288071,192.168.1.4,192.168.1.5,4290418671,2345992929,79,1,36692
97,1574590021.297613,192.168.1.4,192.168.1.5,1395147226,1142676359,16406,1,53098
98,1574590021.2977,192.168.1.4,192.168.1.5,1395163632,1142676359,11584,1,64682
99,1574590021.297936,192.168.1.4,192.168.1.5,1395175216,1142676359,8437,1,73119
100,1574590021.298387,192.168.1.4,192.168.1.5,2657761739,2714419046,2266,1,75385
101,1574590021.299628,192.168.1.5,192.168.1.4,2714419046,2657764005,74,0,75311
102,1574590021.299837,192.168.1.5,192.168.1.4,2714419120,2657764005,247,0,75064
103,1574590021.300026,192.168.1.4,192.168.1.5,2657764005,2714419367,79,1,75143
104,1574590021.300778,192.168.1.4,192.168.1.5,2657764084,2714419367,79,1,75222
105,1574590021.304647,192.168.1.4,192.168.1.5,1802306317,3999381521,2266,1,77488
106,1574590021.305905,192.168.1.5,192.168.1.4,3999381521,1802308583,74,0,77414
107,1574590021.306451,192.168.1.5,192.168.1.4,3999381595,1802308583,257,0,77157
108,1574590021.306743,192.168.1.4,192.168.1.5,1042361085,3029927145,2266,1,79423
109,1574590021.307087,192.168.1.4,192.168.1.5,1802308583,3999381852,79,1,79502
110,1574590021.307165,192.168.1.4,192.168.1.5,1802308662,3999381852,79,1,79581
111,1574590021.308529,192.168.1.5,192.168.1.4,3029927145,1042363351,74,0,79507
112,1574590021.308685,192.168.1.5,192.168.1.4,3029927219,1042363351,257,0,79250
113,1574590021.309039,192.168.1.4,192.168.1.5,1042363351,3029927476,79,1,79329
114,1574590021.312678,192.168.1.4,192.168.1.5,1042363430,3029927476,79,1,79408
115,1574590021.313473,192.168.1.5,192.168.1.4,1142676359,1395183653,61,0,79347
116,1574590021.314011,192.168.1.4,192.168.1.5,1395183653,1142676420,4408,1,83755
117,1574590023.620497,192.168.1.4,192.168.1.5,4290418750,2345992929,91,1,83846
118,1574590023.620517,192.168.1.4,192.168.1.5,2657764163,2714419367,91,1,83937
119,1574590023.621005,192.168.1.5,192.168.1.4,2714419367,2657764254,539,0,83398
120,1574590023.621114,192.168.1.5,192.168.1.4,2345992929,4290418841,539,0,82859
121,1574590023.673178,192.168.1.4,192.168.1.5,2657764254,2714419906,2070,1,84929
122,1574590023.67329,192.168.1.4,192.168.1.5,4290418841,2345993468,2070,1,86999
123,1574590023.714389,192.168.1.4,192.168.1.5,4290420911,2345993468,1889,1,88888
124,1574590023.714439,192.168.1.4,192.168.1.5,2657766324,2714419906,1448,1,90336
125,1574590023.715975,192.168.1.4,192.168.1.5,2657767772,2714419906,442,1,90778
126,1574590023.718103,192.168.1.5,192.168.1.4,2345993468,4290422800,86,0,90692
127,1574590023.721264,192.168.1.5,192.168.1.4,2714419906,2657768214,86,0,90606
128,1574590023.721842,192.168.1.5,192.168.1.4,2714419992,2657768214,24,0,90582
129,1574590023.722181,192.168.1.4,192.168.1.5,2657768214,2714420016,24,1,90606
130,1574590023.723226,192.168.1.5,192.168.1.4,2345993554,4290422800,108,0,90498
131,1574590023.73654,192.168.1.5,192.168.1.4,2345993662,4290422800,268,0,90230
132,1574590023.736704,192.168.1.5,192.168.1.4,2345993930,4290422800,138,0,90092
133,1574590023.755463,192.168.1.4,192.168.1.5,4290422800,2345994068,586,1,90678
134,1574590023.755821,192.168.1.5,192.168.1.4,2345994068,4290423386,53,0,90625
135,1574590023.756041,192.168.1.4,192.168.1.5,4290423386,2345994121,53,1,90678
136,1574590023.804347,192.168.1.4,192.168.1.5,4290423439,2345994121,2034,1,92712
137,1574590023.815927,192.168.1.5,192.168.1.4,2345994121,4290425473,61,0,92651
138,1574590023.81978,192.168.1.5,192.168.1.4,193950247,1274139800,343,0,92308
139,1574590023.820081,192.168.1.4,192.168.1.5,1274139800,193950590,99,1,92407
140,1574590023.820325,192.168.1.5,192.168.1.4,193950590,1274139899,382,0,92025
141,1574590023.8317,192.168.1.4,192.168.1.5,1274139899,193950972,2266,1,94291
142,1574590023.832621,192.168.1.5,192.168.1.4,193950972,1274142165,74,0,94217
143,1574590023.832735,192.168.1.5,192.168.1.4,193951046,1274142165,241,0,93976
144,1574590023.832971,192.168.1.4,192.168.1.5,1274142165,193951287,79,1,94055
145,1574590023.832984,192.168.1.4,192.168.1.5,1274142244,193951287,79,1,94134
146,1574590023.838709,192.168.1.5,192.168.1.4,613186162,403781528,343,0,93791
147,1574590023.839276,192.168.1.4,192.168.1.5,403781528,613186505,99,1,93890
148,1574590023.839526,192.168.1.5,192.168.1.4,613186505,403781627,382,0,93508
149,1574590023.842089,192.168.1.5,192.168.1.4,1364497755,715768692,343,0,93165
150,1574590023.846776,192.168.1.4,192.168.1.5,715768692,1364498098,99,1,93264
151,1574590023.847159,192.168.1.5,192.168.1.4,1364498098,715768791,382,0,92882
152,1574590023.8513,192.168.1.5,192.168.1.4,4252983580,1420201457,343,0,92539
153,1574590023.853245,192.168.1.5,192.168.1.4,3999485837,1347499450,343,0,92196
154,1574590023.859407,192.168.1.4,192.168.1.5,715768791,1364498480,2266,1,94462
155,1574590023.860028,192.168.1.4,192.168.1.5,1420201457,4252983923,99,1,94561
156,1574590023.860431,192.168.1.4,192.168.1.5,1347499450,3999486180,99,1,94660
157,1574590023.860726,192.168.1.5,192.168.1.4,1364498480,715771057,74,0,94586
158,1574590023.860859,192.168.1.5,192.168.1.4,1364498554,715771057,245,0,94341
159,1574590023.861077,192.168.1.5,192.168.1.4,4252983923,1420201556,382,0,93959
160,1574590023.861325,192.168.1.5,192.168.1.4,3999486180,1347499549,382,0,93577
161,1574590023.862433,192.168.1.5,192.168.1.4,1142676420,1395188061,117,0,93460
162,1574590023.865804,192.168.1.5,192.168.1.4,1955542178,3016747093,343,0,93117
163,1574590023.866695,192.168.1.4,192.168.1.5,403781627,613186887,2266,1,95383
164,1574590023.867497,192.168.1.5,192.168.1.4,613186887,403783893,74,0,95309
165,1574590023.867608,192.168.1.5,192.168.1.4,613186961,403783893,245,0,95064
166,1574590023.87306,192.168.1.5,192.168.1.4,1364498554,715771057,245,0,94819
167,1574590023.873434,192.168.1.4,192.168.1.5,403783893,613187206,79,1,94898
168,1574590023.873517,192.168.1.4,192.168.1.5,403783972,613187206,79,1,94977
169,1574590023.874605,192.168.1.4,192.168.1.5,3016747093,1955542521,99,1,95076
170,1574590023.874876,192.168.1.5,192.168.1.4,1955542521,3016747192,382,0,94694
171,1574590023.875716,192.168.1.5,192.168.1.4,2414050638,2122211969,343,0,94351
172,1574590023.876162,192.168.1.4,192.168.1.5,1802308741,3999381852,91,1,94442
173,1574590023.876589,192.168.1.4,192.168.1.5,1042363509,3029927476,91,1,94533
174,1574590023.876932,192.168.1.5,192.168.1.4,3052286793,2699479087,343,0,94190
175,1574590023.877282,192.168.1.5,192.168.1.4,3999381852,1802308832,539,0,93651
176,1574590023.878449,192.168.1.5,192.168.1.4,3029927476,1042363600,539,0,93112
177,1574590023.879493,192.168.1.5,192.168.1.4,2394594589,193722047,343,0,92769
178,1574590023.882632,192.168.1.4,192.168.1.5,2122211969,2414050981,99,1,92868
179,1574590023.882907,192.168.1.5,192.168.1.4,2414050981,2122212068,382,0,92486
180,1574590023.886527,192.168.1.4,192.168.1.5,2699479087,3052287136,99,1,92585
181,1574590023.886801,192.168.1.5,192.168.1.4,3052287136,2699479186,382,0,92203
182,1574590023.899749,192.168.1.4,192.168.1.5,715771057,1364498799,79,1,92282
183,1574590023.899767,192.168.1.4,192.168.1.5,715771136,1364498799,79,1,92361
184,1574590023.900868,192.168.1.4,192.168.1.5,193722047,2394594932,99,1,92460
185,1574590023.901247,192.168.1.5,192.168.1.4,2394594932,193722146,382,0,92078
186,1574590023.909272,192.168.1.4,192.168.1.5,1395188061,1142676537,1540,1,93618
187,1574590023.909795,192.168.1.4,192.168.1.5,1395189601,1142676537,2858,1,96476
188,1574590023.915445,192.168.1.4,192.168.1.5,3016747192,1955542903,2266,1,98742
189,1574590023.916674,192.168.1.5,192.168.1.4,1955542903,3016749458,74,0,98668
190,1574590023.916785,192.168.1.5,192.168.1.4,1955542977,3016749458,257,0,98411
191,1574590023.919868,192.168.1.4,192.168.1.5,1042363600,3029928015,2070,1,100481
192,1574590023.919895,192.168.1.4,192.168.1.5,1802308832,3999382391,2070,1,102551
193,1574590023.922185,192.168.1.4,192.168.1.5,1347499549,3999486562,2266,1,104817
194,1574590023.923203,192.168.1.5,192.168.1.4,3999486562,1347501815,74,0,104743
195,1574590023.923303,192.168.1.5,192.168.1.4,3999486636,1347501815,237,0,104506
196,1574590023.924062,192.168.1.4,192.168.1.5,1395192459,1142676537,14480,1,118986
197,1574590023.924266,192.168.1.4,192.168.1.5,1395206939,1142676537,17376,1,136362
198,1574590023.924353,192.168.1.4,192.168.1.5,1395224315,1142676537,2242,1,138604
199,1574590023.924359,192.168.1.4,192.168.1.5,1347501815,3999486873,79,1,138683
200,1574590023.924441,192.168.1.4,192.168.1.5,1347501894,3999486873,79,1,138762
201,1574590023.925148,192.168.1.4,192.168.1.5,1395226557,1142676537,2858,1,141620
202,1574590023.925723,192.168.1.4,192.168.1.5,1395229415,1142676537,1440,1,143060
203,1574590023.926409,192.168.1.4,192.168.1.5,1395230855,1142676537,1440,1,144500
204,1574590023.927003,192.168.1.4,192.168.1.5,1420201556,4252984305,2266,1,146766
205,1574590023.927844,192.168.1.5,192.168.1.4,4252984305,1420203822,74,0,146692
206,1574590023.92806,192.168.1.5,192.168.1.4,4252984379,1420203822,245,0,146447
207,1574590023.929263,192.168.1.4,192.168.1.5,1420203822,4252984624,79,1,146526
208,1574590023.929373,192.168.1.4,192.168.1.5,1420203901,4252984624,79,1,146605
209,1574590023.932092,192.168.1.4,192.168.1.5,2699479186,3052287518,2266,1,148871
210,1574590023.932316,192.168.1.4,192.168.1.5,3016749458,1955543234,79,1,148950
211,1574590023.932381,192.168.1.4,192.168.1.5,3016749537,1955543234,79,1,149029
212,1574590023.933435,192.168.1.5,192.168.1.4,3052287518,2699481452,74,0,148955
213,1574590023.933582,192.168.1.5,192.168.1.4,3052287592,2699481452,257,0,148698
214,1574590023.93712,192.168.1.4,192.168.1.5,193722146,2394595314,2266,1,150964
215,1574590023.938214,192.168.1.4,192.168.1.5,2699481452,3052287849,79,1,151043
216,1574590023.938238,192.168.1.4,192.168.1.5,2699481531,3052287849,79,1,151122
217,1574590023.938565,192.168.1.5,192.168.1.4,2394595314,193724412,74,0,151048
218,1574590023.938677,192.168.1.5,192.168.1.4,2394595388,193724412,257,0,150791
219,1574590023.939129,192.168.1.4,192.168.1.5,2122212068,2414051363,2266,1,153057
220,1574590023.93987,192.168.1.4,192.168.1.5,193724412,2394595645,79,1,153136
221,1574590023.940041,192.168.1.5,192.168.1.4,2414051363,2122214334,74,0,153062
222,1574590023.9401,192.168.1.4,192.168.1.5,193724491,2394595645,79,1,153141
223,1574590023.94028,192.168.1.5,192.168.1.4,2414051437,2122214334,257,0,152884
224,1574590023.940328,192.168.1.4,192.168.1.5,2122214334,2414051437,79,1,152963
225,1574590023.941175,192.168.1.4,192.168.1.5,2122214413,2414051694,79,1,153042
226,1574590023.941754,192.168.1.4,192.168.1.5,1395232295,1142676537,11584,1,164626
227,1574590023.941826,192.168.1.4,192.168.1.5,1395243879,1142676537,4822,1,169448
228,1574590023.941839,192.168.1.4,192.168.1.5,1395248701,1142676537,16406,1,185854
229,1574590023.941866,192.168.1.4,192.168.1.5,1395265107,1142676537,1286,1,187140
230,1574590023.943168,192.168.1.4,192.168.1.5,1395266393,1142676537,5694,1,192834
231,1574590023.943924,192.168.1.4,192.168.1.5,1395272087,1142676537,2858,1,195692
232,1574590023.945885,192.168.1.4,192.168.1.5,1395274945,1142676537,5452,1,201144
233,1574590023.947097,192.168.1.5,192.168.1.4,1142676537,1395280397,61,0,201083
234,1574590023.962239,192.168.1.4,192.168.1.5,1802310902,3999382391,2724,1,203807
235,1574590023.962294,192.168.1.4,192.168.1.5,1042365670,3029928015,2722,1,206529
236,1574590023.976844,192.168.1.5,192.168.1.4,3999382391,1802313626,86,0,206443
237,1574590023.980668,192.168.1.5,192.168.1.4,3029928015,1042368392,86,0,206357
238,1574590023.993549,192.168.1.5,192.168.1.4,3029928101,1042368392,24,0,206333
239,1574590023.993754,192.168.1.5,192.168.1.4,3999382477,1802313626,108,0,206225
240,1574590023.993994,192.168.1.5,192.168.1.4,1955543234,3016749616,24,0,206201
241,1574590023.994114,192.168.1.5,192.168.1.4,2414051694,2122214492,24,0,206177
242,1574590023.994229,192.168.1.5,192.168.1.4,3052287849,2699481610,24,0,206153
243,1574590023.994507,192.168.1.4,192.168.1.5,1042368392,3029928125,24,1,206177
244,1574590023.994948,192.168.1.5,192.168.1.4,2394595645,193724570,24,0,206153
245,1574590024.001361,192.168.1.5,192.168.1.4,3999382585,1802313626,351,0,205802
246,1574590024.001668,192.168.1.5,192.168.1.4,3999382936,1802313626,161,0,205641
247,1574590024.001778,192.168.1.5,192.168.1.4,3999383097,1802313626,158,0,205483
248,1574590024.001929,192.168.1.5,192.168.1.4,3999383255,1802313626,158,0,205325
249,1574590024.002097,192.168.1.5,192.168.1.4,3999383413,1802313626,160,0,205165
250,1574590024.002282,192.168.1.5,192.168.1.4,3999383573,1802313626,159,0,205006
251,1574590024.019692,192.168.1.4,192.168.1.5,1802313626,3999383732,586,1,205592
252,1574590024.033663,192.168.1.5,192.168.1.4,3999383732,1802314212,53,0,205539
253,1574590024.03423,192.168.1.4,192.168.1.5,1802314212,3999383785,53,1,205592
254,1574590024.071659,192.168.1.5,192.168.1.4,2360121080,3139663294,343,0,205249
255,1574590024.072069,192.168.1.4,192.168.1.5,3139663294,2360121423,99,1,205348
256,1574590024.072382,192.168.1.5,192.168.1.4,2360121423,3139663393,382,0,204966
257,1574590024.074154,192.168.1.4,192.168.1.5,1802314265,3999383785,13032,1,217998
258,1574590024.074345,192.168.1.4,192.168.1.5,1802327297,3999383785,8688,1,226686
259,1574590024.074496,192.168.1.4,192.168.1.5,1802335985,3999383785,8516,1,235202
260,1574590024.082672,192.168.1.4,192.168.1.5,3139663393,2360121805,2266,1,237468
261,1574590024.08349,192.168.1.5,192.168.1.4,2360121805,3139665659,74,0,237394
262,1574590024.083743,192.168.1.4,192.168.1.5,3139665659,2360121879,79,1,237473
263,1574590024.083996,192.168.1.5,192.168.1.4,2360121879,3139665738,255,0,237218
264,1574590024.084062,192.168.1.4,192.168.1.5,3139665738,2360121879,79,1,237297
265,1574590024.084713,192.168.1.5,192.168.1.4,3999383785,1802344501,61,0,237236
266,1574590024.085753,192.168.1.5,192.168.1.4,388162123,3591077532,343,0,236893
267,1574590024.086142,192.168.1.4,192.168.1.5,3591077532,388162466,99,1,236992
268,1574590024.086358,192.168.1.5,192.168.1.4,388162466,3591077631,382,0,236610
269,1574590024.097014,192.168.1.4,192.168.1.5,3591077631,388162848,2266,1,238876
270,1574590024.098082,192.168.1.5,192.168.1.4,388162848,3591079897,74,0,238802
271,1574590024.0982,192.168.1.5,192.168.1.4,388162922,3591079897,265,0,238537
272,1574590024.098842,192.168.1.4,192.168.1.5,3591079897,388163187,79,1,238616
273,1574590024.099463,192.168.1.4,192.168.1.5,3591079976,388163187,79,1,238695
274,1574590024.105435,192.168.1.4,192.168.1.5,1802344501,3999383846,2070,1,240765
275,1574590024.121389,192.168.1.4,192.168.1.5,1802346571,3999383846,16406,1,257171
276,1574590024.121448,192.168.1.4,192.168.1.5,1802362977,3999383846,5792,1,262963
277,1574590024.121518,192.168.1.4,192.168.1.5,1802368769,3999383846,5792,1,268755
278,1574590024.121827,192.168.1.4,192.168.1.5,1802374561,3999383846,6896,1,275651
279,1574590024.130219,192.168.1.5,192.168.1.4,674700894,2482992927,343,0,275308
280,1574590024.131312,192.168.1.4,192.168.1.5,2482992927,674701237,99,1,275407
281,1574590024.131756,192.168.1.5,192.168.1.4,674701237,2482993026,382,0,275025
282,1574590024.142303,192.168.1.4,192.168.1.5,2482993026,674701619,2266,1,277291
283,1574590024.143309,192.168.1.5,192.168.1.4,674701619,2482995292,74,0,277217
284,1574590024.143441,192.168.1.5,192.168.1.4,674701693,2482995292,265,0,276952
285,1574590024.143637,192.168.1.4,192.168.1.5,2482995292,674701958,79,1,277031
286,1574590024.1437,192.168.1.4,192.168.1.5,2482995371,674701958,79,1,277110
287,1574590024.145322,192.168.1.4,192.168.1.5,1802381457,3999383846,16406,1,293516
288,1574590024.145552,192.168.1.4,192.168.1.5,1802397863,3999383846,16406,1,309922
289,1574590024.146172,192.168.1.4,192.168.1.5,1802414269,3999383846,1286,1,311208
290,1574590024.151331,192.168.1.5,192.168.1.4,2784995912,3481173290,343,0,310865
291,1574590024.152425,192.168.1.4,192.168.1.5,3481173290,2784996255,99,1,310964
292,1574590024.152779,192.168.1.5,192.168.1.4,2784996255,3481173389,382,0,310582
293,1574590024.16406,192.168.1.4,192.168.1.5,1802415555,3999383846,16406,1,326988
294,1574590024.164527,192.168.1.4,192.168.1.5,1802431961,3999383846,16406,1,343394
295,1574590024.164596,192.168.1.4,192.168.1.5,1802448367,3999383846,1286,1,344680
296,1574590024.169101,192.168.1.5,192.168.1.4,1778738373,2373816127,343,0,344337
297,1574590024.174968,192.168.1.4,192.168.1.5,2373816127,1778738716,99,1,344436
298,1574590024.175035,192.168.1.4,192.168.1.5,3481173389,2784996637,2266,1,346702
299,1574590024.176092,192.168.1.5,192.168.1.4,2784996637,3481175655,74,0,346628
300,1574590024.176258,192.168.1.5,192.168.1.4,2784996711,3481175655,265,0,346363
301,1574590024.176503,192.168.1.4,192.168.1.5,3481175655,2784996976,79,1,346442
302,1574590024.17659,192.168.1.4,192.168.1.5,3481175734,2784996976,79,1,346521
303,1574590024.176777,192.168.1.5,192.168.1.4,1778738716,2373816226,382,0,346139
304,1574590024.181735,192.168.1.4,192.168.1.5,1802449653,3999383846,16406,1,362545
305,1574590024.181859,192.168.1.4,192.168.1.5,1802466059,3999383846,11584,1,374129
306,1574590024.182082,192.168.1.4,192.168.1.5,1802477643,3999383846,4822,1,378951
307,1574590024.182113,192.168.1.4,192.168.1.5,1802482465,3999383846,1914,1,380865
308,1574590024.187635,192.168.1.5,192.168.1.4,221767651,715836245,343,0,380522
309,1574590024.188365,192.168.1.4,192.168.1.5,715836245,221767994,99,1,380621
310,1574590024.188783,192.168.1.5,192.168.1.4,221767994,715836344,382,0,380239
311,1574590024.2071,192.168.1.4,192.168.1.5,2373816226,1778739098,2266,1,382505
312,1574590024.208552,192.168.1.5,192.168.1.4,1778739098,2373818492,74,0,382431
313,1574590024.208703,192.168.1.5,192.168.1.4,1778739172,2373818492,265,0,382166
314,1574590024.208977,192.168.1.4,192.168.1.5,2373818492,1778739437,79,1,382245
315,1574590024.208995,192.168.1.4,192.168.1.5,2373818571,1778739437,79,1,382324
316,1574590024.212931,192.168.1.4,192.168.1.5,715836344,221768376,2266,1,384590
317,1574590024.214119,192.168.1.5,192.168.1.4,221768376,715838610,74,0,384516
318,1574590024.21427,192.168.1.5,192.168.1.4,221768450,715838610,265,0,384251
319,1574590024.214491,192.168.1.4,192.168.1.5,715838610,221768715,79,1,384330
320,1574590024.214575,192.168.1.4,192.168.1.5,715838689,221768715,79,1,384409
321,1574590024.22567,192.168.1.4,192.168.1.5,1802484379,3999383846,14577,1,398986
322,1574590024.227346,192.168.1.5,192.168.1.4,3575603518,374505469,343,0,398643
323,1574590024.227892,192.168.1.4,192.168.1.5,374505469,3575603861,99,1,398742
324,1574590024.228189,192.168.1.5,192.168.1.4,3575603861,374505568,382,0,398360
325,1574590024.24315,192.168.1.4,192.168.1.5,374505568,3575604243,2266,1,400626
326,1574590024.244201,192.168.1.5,192.168.1.4,3575604243,374507834,74,0,400552
327,1574590024.244355,192.168.1.5,192.168.1.4,3575604317,374507834,265,0,400287
328,1574590024.244684,192.168.1.4,192.168.1.5,374507834,3575604582,79,1,400366
329,1574590024.253125,192.168.1.4,192.168.1.5,374507913,3575604582,79,1,400445
330,1574590025.263978,192.168.1.5,192.168.1.4,2955199938,517171613,343,0,400102
331,1574590025.264562,192.168.1.4,192.168.1.5,517171613,2955200281,99,1,400201
332,1574590025.267921,192.168.1.5,192.168.1.4,134046912,2199844352,343,0,399858
333,1574590025.268669,192.168.1.4,192.168.1.5,2199844352,134047255,99,1,399957
334,1574590025.269872,192.168.1.5,192.168.1.4,134047255,2199844451,382,0,399575
335,1574590025.27077,192.168.1.5,192.168.1.4,2955200281,517171712,382,0,399193
336,1574590025.295242,192.168.1.4,192.168.1.5,2199844451,134047637,2266,1,401459
337,1574590025.295665,192.168.1.4,192.168.1.5,517171712,2955200663,2266,1,403725
338,1574590025.296682,192.168.1.5,192.168.1.4,134047637,2199846717,74,0,403651
339,1574590025.296894,192.168.1.5,192.168.1.4,134047711,2199846717,241,0,403410
340,1574590025.297122,192.168.1.4,192.168.1.5,2199846717,134047952,79,1,403489
341,1574590025.29719,192.168.1.4,192.168.1.5,2199846796,134047952,79,1,403568
342,1574590025.298846,192.168.1.5,192.168.1.4,2955200663,517173978,74,0,403494
343,1574590025.299062,192.168.1.5,192.168.1.4,2955200737,517173978,241,0,403253
344,1574590025.299428,192.168.1.4,192.168.1.5,517173978,2955200978,79,1,403332
345,1574590025.299445,192.168.1.4,192.168.1.5,517174057,2955200978,79,1,403411
346,1574590025.479394,192.168.1.5,192.168.1.4,3708740466,876316943,343,0,403068
347,1574590025.48014,192.168.1.4,192.168.1.5,876316943,3708740809,99,1,403167
348,1574590025.481527,192.168.1.5,192.168.1.4,4115069013,3513879678,343,0,402824
349,1574590025.482053,192.168.1.4,192.168.1.5,3513879678,4115069356,99,1,402923
350,1574590025.482824,192.168.1.5,192.168.1.4,553530010,1964326547,343,0,402580
351,1574590025.4833,192.168.1.4,192.168.1.5,1964326547,553530353,99,1,402679
352,1574590025.483897,192.168.1.5,192.168.1.4,4115069356,3513879777,382,0,402297
353,1574590025.484399,192.168.1.5,192.168.1.4,3708740809,876317042,382,0,401915
354,1574590025.48477,192.168.1.5,192.168.1.4,553530353,1964326646,382,0,401533
355,1574590025.498725,192.168.1.4,192.168.1.5,1964326646,553530735,2266,1,403799
356,1574590025.500611,192.168.1.5,192.168.1.4,553530735,1964328912,74,0,403725
357,1574590025.500801,192.168.1.5,192.168.1.4,553530809,1964328912,241,0,403484
358,1574590025.51294,192.168.1.5,192.168.1.4,553530809,1964328912,241,0,403243
359,1574590025.515546,192.168.1.4,192.168.1.5,876317042,3708741191,2266,1,405509
360,1574590025.517313,192.168.1.5,192.168.1.4,3708741191,876319308,74,0,405435
361,1574590025.517534,192.168.1.5,192.168.1.4,3708741265,876319308,241,0,405194
362,1574590025.517906,192.168.1.4,192.168.1.5,3513879777,4115069738,2266,1,407460
363,1574590025.518326,192.168.1.4,192.168.1.5,876319308,3708741506,79,1,407539
364,1574590025.518421,192.168.1.4,192.168.1.5,876319387,3708741506,79,1,407618
365,1574590025.519387,192.168.1.4,192.168.1.5,1964328912,553531050,79,1,407697
366,1574590025.519505,192.168.1.4,192.168.1.5,1964328991,553531050,79,1,407776
367,1574590025.520762,192.168.1.5,192.168.1.4,4115069738,3513882043,74,0,407702
368,1574590025.520938,192.168.1.5,192.168.1.4,4115069812,3513882043,241,0,407461
369,1574590025.521272,192.168.1.4,192.168.1.5,3513882043,4115070053,79,1,407540
370,1574590025.521451,192.168.1.4,192.168.1.5,3513882122,4115070053,79,1,407619
371,1574590028.504044,192.168.1.5,192.168.1.4,2334845831,3707287242,343,0,407276
372,1574590028.504793,192.168.1.4,192.168.1.5,3707287242,2334846174,99,1,407375
373,1574590028.505381,192.168.1.5,192.168.1.4,2334846174,3707287341,382,0,406993
374,1574590028.521504,192.168.1.4,192.168.1.5,3707287341,2334846556,2266,1,409259
375,1574590028.522594,192.168.1.5,192.168.1.4,2334846556,3707289607,74,0,409185
376,1574590028.522765,192.168.1.5,192.168.1.4,2334846630,3707289607,237,0,408948
377,1574590028.523,192.168.1.4,192.168.1.5,3707289607,2334846867,79,1,409027
378,1574590028.523104,192.168.1.4,192.168.1.5,3707289686,2334846867,79,1,409106
379,1574590030.916828,192.168.1.4,192.168.1.5,3481175813,2784996976,91,1,409197
380,1574590030.917127,192.168.1.4,192.168.1.5,2699481610,3052287873,91,1,409288
381,1574590030.917144,192.168.1.4,192.168.1.5,1347501973,3999486873,91,1,409379
382,1574590030.917289,192.168.1.4,192.168.1.5,2699481701,3052287873,24,1,409403
383,1574590030.91967,192.168.1.4,192.168.1.5,1274142323,193951287,91,1,409494
384,1574590030.919984,192.168.1.5,192.168.1.4,3999486873,1347502064,539,0,408955
385,1574590030.920148,192.168.1.5,192.168.1.4,2784996976,3481175904,539,0,408416
386,1574590030.920436,192.168.1.4,192.168.1.5,403784051,613187206,91,1,408507
387,1574590030.920611,192.168.1.4,192.168.1.5,3016749616,1955543258,91,1,408598
388,1574590030.921023,192.168.1.4,192.168.1.5,3016749707,1955543258,24,1,408622
389,1574590030.923115,192.168.1.4,192.168.1.5,2482995450,674701958,91,1,408713
390,1574590030.923207,192.168.1.5,192.168.1.4,193951287,1274142414,539,0,408174
391,1574590030.923485,192.168.1.5,192.168.1.4,613187206,403784142,539,0,407635
392,1574590030.924694,192.168.1.5,192.168.1.4,674701958,2482995541,539,0,407096
393,1574590030.960776,192.168.1.4,192.168.1.5,3481175904,2784997515,2070,1,409166
394,1574590030.963683,192.168.1.4,192.168.1.5,1347502064,3999487412,2070,1,411236
395,1574590030.963891,192.168.1.4,192.168.1.5,1274142414,193951826,2070,1,413306
396,1574590030.96547,192.168.1.4,192.168.1.5,2482995541,674702497,2070,1,415376
397,1574590030.969131,192.168.1.4,192.168.1.5,403784142,613187745,2070,1,417446
398,1574590031.002325,192.168.1.4,192.168.1.5,3481177974,2784997515,2739,1,420185
399,1574590031.005929,192.168.1.5,192.168.1.4,2784997515,3481180713,115,0,420070
400,1574590031.006372,192.168.1.4,192.168.1.5,1347504134,3999487412,1756,1,421826
401,1574590031.006432,192.168.1.4,192.168.1.5,2482997611,674702497,2739,1,424565
402,1574590031.006652,192.168.1.4,192.168.1.5,1274144484,193951826,1757,1,426322
403,1574590031.008887,192.168.1.5,192.168.1.4,674702497,2483000350,115,0,426207
404,1574590031.010201,192.168.1.4,192.168.1.5,403786212,613187745,1890,1,428097
405,1574590031.023172,192.168.1.5,192.168.1.4,2784997630,3481180713,115,0,427982
406,1574590031.02338,192.168.1.5,192.168.1.4,388163187,3591080055,24,0,427958
407,1574590031.02365,192.168.1.5,192.168.1.4,1778739437,2373818650,24,0,427934
408,1574590031.02389,192.168.1.5,192.168.1.4,674702612,2483000350,24,0,427910
409,1574590031.024305,192.168.1.4,192.168.1.5,2483000350,674702636,24,1,427934
410,1574590031.027177,192.168.1.5,192.168.1.4,193951826,1274146241,86,0,427848
411,1574590031.028528,192.168.1.5,192.168.1.4,3999487412,1347505890,86,0,427762
412,1574590031.029851,192.168.1.5,192.168.1.4,613187745,403788102,86,0,427676
413,1574590031.034131,192.168.1.5,192.168.1.4,2784997745,3481180713,354,0,427322
414,1574590031.034296,192.168.1.5,192.168.1.4,2784998099,3481180713,178,0,427144
415,1574590031.034411,192.168.1.5,192.168.1.4,2784998277,3481180713,178,0,426966
416,1574590031.034591,192.168.1.5,192.168.1.4,2784998455,3481180713,177,0,426789
417,1574590031.034701,192.168.1.5,192.168.1.4,2784998632,3481180713,177,0,426612
418,1574590031.034815,192.168.1.5,192.168.1.4,2784998809,3481180713,177,0,426435
419,1574590031.035184,192.168.1.5,192.168.1.4,193951912,1274146241,108,0,426327
420,1574590031.035939,192.168.1.5,192.168.1.4,134047952,2199846875,24,0,426303
421,1574590031.036119,192.168.1.5,192.168.1.4,2955200978,517174136,24,0,426279
422,1574590031.036243,192.168.1.5,192.168.1.4,553531050,1964329070,24,0,426255
423,1574590031.036357,192.168.1.5,192.168.1.4,3708741506,876319466,24,0,426231
424,1574590031.036469,192.168.1.5,192.168.1.4,4115070053,3513882201,24,0,426207
425,1574590031.037739,192.168.1.5,192.168.1.4,3999487498,1347505890,108,0,426099
426,1574590031.039061,192.168.1.5,192.168.1.4,613187831,403788102,108,0,425991
427,1574590031.039309,192.168.1.5,192.168.1.4,1364498799,715771215,24,0,425967
428,1574590031.039506,192.168.1.5,192.168.1.4,4252984624,1420203980,24,0,425943
429,1574590031.04184,192.168.1.4,192.168.1.5,3481180713,2784998986,375,1,426318
430,1574590031.04745,192.168.1.5,192.168.1.4,193952020,1274146241,381,0,425937
431,1574590031.047623,192.168.1.5,192.168.1.4,193952401,1274146241,118,0,425819
432,1574590031.047737,192.168.1.5,192.168.1.4,193952519,1274146241,115,0,425704
433,1574590031.047909,192.168.1.5,192.168.1.4,193952634,1274146241,107,0,425597
434,1574590031.048027,192.168.1.5,192.168.1.4,193952741,1274146241,158,0,425439
435,1574590031.048153,192.168.1.5,192.168.1.4,193952899,1274146241,110,0,425329
436,1574590031.048299,192.168.1.5,192.168.1.4,193953009,1274146241,109,0,425220
437,1574590031.048436,192.168.1.5,192.168.1.4,193953118,1274146241,109,0,425111
438,1574590031.048585,192.168.1.5,192.168.1.4,193953227,1274146241,109,0,425002
439,1574590031.048743,192.168.1.5,192.168.1.4,3999487606,1347505890,266,0,424736
440,1574590031.050758,192.168.1.5,192.168.1.4,613187939,403788102,266,0,424470
441,1574590031.050902,192.168.1.5,192.168.1.4,613188205,403788102,110,0,424360
442,1574590031.051038,192.168.1.5,192.168.1.4,613188315,403788102,108,0,424252
443,1574590031.051144,192.168.1.5,192.168.1.4,2784998986,3481181088,60,0,424192
444,1574590031.057863,192.168.1.4,192.168.1.5,3481181088,2784999046,60,1,424252
445,1574590031.060674,192.168.1.4,192.168.1.5,1347505890,3999487872,586,1,424838
446,1574590031.060784,192.168.1.4,192.168.1.5,1274146241,193953336,586,1,425424
447,1574590031.061156,192.168.1.5,192.168.1.4,3999487872,1347506476,53,0,425371
448,1574590031.061335,192.168.1.5,192.168.1.4,193953336,1274146827,53,0,425318
449,1574590031.064311,192.168.1.4,192.168.1.5,403788102,613188423,586,1,425904
450,1574590031.065019,192.168.1.5,192.168.1.4,613188423,403788688,53,0,425851
451,1574590031.069128,192.168.1.4,192.168.1.5,1274146827,193953389,53,1,425904
452,1574590031.07347,192.168.1.4,192.168.1.5,1347506476,3999487925,53,1,425957
453,1574590031.073506,192.168.1.4,192.168.1.5,403788688,613188476,53,1,426010
454,1574590031.098243,192.168.1.4,192.168.1.5,3481181148,2784999046,13032,1,439042
455,1574590031.098557,192.168.1.4,192.168.1.5,3481194180,2784999046,8688,1,447730
456,1574590031.098971,192.168.1.4,192.168.1.5,3481202868,2784999046,5953,1,453683
457,1574590031.10861,192.168.1.4,192.168.1.5,3481208821,2784999046,2070,1,455753
458,1574590031.10866,192.168.1.4,192.168.1.5,3481210891,2784999046,2070,1,457823
459,1574590031.110106,192.168.1.4,192.168.1.5,1274146880,193953389,13032,1,470855
460,1574590031.110294,192.168.1.4,192.168.1.5,1274159912,193953389,11584,1,482439
461,1574590031.112348,192.168.1.4,192.168.1.5,1274171496,193953389,2740,1,485179
462,1574590031.114195,192.168.1.4,192.168.1.5,1347506529,3999487925,6448,1,491627
463,1574590031.114276,192.168.1.4,192.168.1.5,403788741,613188476,7240,1,498867
464,1574590031.114503,192.168.1.4,192.168.1.5,403795981,613188476,5792,1,504659
465,1574590031.114538,192.168.1.4,192.168.1.5,403801773,613188476,8688,1,513347
466,1574590031.114739,192.168.1.4,192.168.1.5,403810461,613188476,5689,1,519036
467,1574590031.114997,192.168.1.4,192.168.1.5,403816150,613188476,2070,1,521106
468,1574590031.115069,192.168.1.4,192.168.1.5,403818220,613188476,2070,1,523176
469,1574590031.115154,192.168.1.4,192.168.1.5,403820290,613188476,1598,1,524774
470,1574590031.117214,192.168.1.4,192.168.1.5,403821888,613188476,1440,1,526214
471,1574590031.118739,192.168.1.4,192.168.1.5,403823328,613188476,2070,1,528284
472,1574590031.130441,192.168.1.4,192.168.1.5,3481212961,2784999046,16406,1,544690
473,1574590031.13058,192.168.1.4,192.168.1.5,3481229367,2784999046,11584,1,556274
474,1574590031.130795,192.168.1.4,192.168.1.5,3481240951,2784999046,4848,1,561122
475,1574590031.13304,192.168.1.4,192.168.1.5,3481245799,2784999046,2070,1,563192
476,1574590031.133665,192.168.1.4,192.168.1.5,3481247869,2784999046,810,1,564002
477,1574590031.133886,192.168.1.4,192.168.1.5,3481248679,2784999046,1440,1,565442
478,1574590031.134167,192.168.1.4,192.168.1.5,3481250119,2784999046,1440,1,566882
479,1574590031.136185,192.168.1.5,192.168.1.4,193953389,1274174236,61,0,566821
480,1574590031.136568,192.168.1.4,192.168.1.5,1274174236,193953450,13032,1,579853
481,1574590031.136706,192.168.1.4,192.168.1.5,1274187268,193953450,3374,1,583227
482,1574590031.136714,192.168.1.4,192.168.1.5,1274190642,193953450,2072,1,585299
483,1574590031.141037,192.168.1.5,192.168.1.4,3999487925,1347512977,61,0,585238
484,1574590031.162345,192.168.1.4,192.168.1.5,403825398,613188476,16406,1,601644
485,1574590031.162429,192.168.1.4,192.168.1.5,403841804,613188476,7114,1,608758
486,1574590031.178303,192.168.1.4,192.168.1.5,1274192714,193953450,16406,1,625164
487,1574590031.178413,192.168.1.4,192.168.1.5,1274209120,193953450,11584,1,636748
488,1574590031.178442,192.168.1.4,192.168.1.5,3481251559,2784999046,7240,1,643988
489,1574590031.178516,192.168.1.4,192.168.1.5,1274220704,193953450,3250,1,647238
490,1574590031.178524,192.168.1.4,192.168.1.5,3481258799,2784999046,9166,1,656404
491,1574590031.178567,192.168.1.4,192.168.1.5,3481267965,2784999046,4344,1,660748
492,1574590031.178676,192.168.1.4,192.168.1.5,3481272309,2784999046,4344,1,665092
493,1574590031.178775,192.168.1.4,192.168.1.5,3481276653,2784999046,1892,1,666984
494,1574590031.193143,192.168.1.4,192.168.1.5,3481278545,2784999046,5792,1,672776
495,1574590031.193291,192.168.1.4,192.168.1.5,3481284337,2784999046,5792,1,678568
496,1574590031.193501,192.168.1.4,192.168.1.5,3481290129,2784999046,4822,1,683390
497,1574590031.193536,192.168.1.4,192.168.1.5,3481294951,2784999046,16406,1,699796
498,1574590031.193673,192.168.1.4,192.168.1.5,3481311357,2784999046,1286,1,701082
499,1574590031.194062,192.168.1.4,192.168.1.5,3481312643,2784999046,2070,1,703152
500,1574590031.194264,192.168.1.4,192.168.1.5,3481314713,2784999046,810,1,703962
501,1574590031.197704,192.168.1.4,192.168.1.5,1274223954,193953450,16406,1,720368
502,1574590031.197797,192.168.1.4,192.168.1.5,1274240360,193953450,13032,1,733400
503,1574590031.197874,192.168.1.4,192.168.1.5,1274253392,193953450,3374,1,736774
504,1574590031.198141,192.168.1.4,192.168.1.5,3481315523,2784999046,2070,1,738844
505,1574590031.198434,192.168.1.4,192.168.1.5,1274256766,193953450,498,1,739342
506,1574590031.198528,192.168.1.4,192.168.1.5,1274257264,193953450,810,1,740152
507,1574590031.198603,192.168.1.4,192.168.1.5,1274258074,193953450,2070,1,742222
508,1574590031.198683,192.168.1.4,192.168.1.5,3481317593,2784999046,810,1,743032
509,1574590031.198834,192.168.1.4,192.168.1.5,1274260144,193953450,810,1,743842
510,1574590031.199352,192.168.1.4,192.168.1.5,3481318403,2784999046,2070,1,745912
511,1574590031.199532,192.168.1.4,192.168.1.5,3481320473,2784999046,810,1,746722
512,1574590031.201884,192.168.1.4,192.168.1.5,1274260954,193953450,2070,1,748792
513,1574590031.202126,192.168.1.4,192.168.1.5,1274263024,193953450,810,1,749602
514,1574590031.202135,192.168.1.4,192.168.1.5,3481321283,2784999046,2070,1,751672
515,1574590031.202757,192.168.1.4,192.168.1.5,3481323353,2784999046,810,1,752482
516,1574590031.202792,192.168.1.4,192.168.1.5,3481324163,2784999046,2070,1,754552
517,1574590031.202931,192.168.1.4,192.168.1.5,3481326233,2784999046,810,1,755362
518,1574590031.203281,192.168.1.4,192.168.1.5,1274263834,193953450,1440,1,756802
519,1574590031.203999,192.168.1.4,192.168.1.5,1274265274,193953450,1440,1,758242
520,1574590031.204741,192.168.1.4,192.168.1.5,3481327043,2784999046,1440,1,759682
521,1574590031.206074,192.168.1.4,192.168.1.5,403848918,613188476,12383,1,772065
522,1574590031.237315,192.168.1.5,192.168.1.4,613188476,403861301,61,0,772004
523,1574590031.293644,192.168.1.4,192.168.1.5,3481328483,2784999046,14480,1,786484
524,1574590031.293894,192.168.1.4,192.168.1.5,3481342963,2784999046,1926,1,788410
525,1574590031.293928,192.168.1.4,192.168.1.5,3481344889,2784999046,3508,1,791918
526,1574590031.294153,192.168.1.4,192.168.1.5,1274266714,193953450,1440,1,793358
527,1574590031.294762,192.168.1.4,192.168.1.5,3481348397,2784999046,1422,1,794780
528,1574590031.296841,192.168.1.4,192.168.1.5,1274268154,193953450,11584,1,806364
529,1574590031.297048,192.168.1.4,192.168.1.5,1274279738,193953450,4822,1,811186
530,1574590031.297102,192.168.1.4,192.168.1.5,1274284560,193953450,14480,1,825666
531,1574590031.297306,192.168.1.4,192.168.1.5,1274299040,193953450,1926,1,827592
532,1574590031.297358,192.168.1.4,192.168.1.5,1274300966,193953450,14480,1,842072
533,1574590031.297533,192.168.1.4,192.168.1.5,1274315446,193953450,1926,1,843998
534,1574590031.297581,192.168.1.4,192.168.1.5,1274317372,193953450,11584,1,855582
535,1574590031.297786,192.168.1.4,192.168.1.5,1274328956,193953450,4514,1,860096
536,1574590031.297826,192.168.1.4,192.168.1.5,3481349819,2784999046,16406,1,876502
537,1574590031.297965,192.168.1.4,192.168.1.5,3481366225,2784999046,13032,1,889534
538,1574590031.298164,192.168.1.4,192.168.1.5,3481379257,2784999046,8688,1,898222
539,1574590031.298255,192.168.1.4,192.168.1.5,3481387945,2784999046,24354,1,922576
540,1574590031.30337,192.168.1.4,192.168.1.5,1274333470,193953450,9948,1,932524
541,1574590031.304165,192.168.1.5,192.168.1.4,2784999046,3481412299,68,0,932456
542,1574590031.304239,192.168.1.4,192.168.1.5,1274343418,193953450,2858,1,935314
543,1574590031.305705,192.168.1.4,192.168.1.5,3481412299,2784999114,2070,1,937384
544,1574590031.307912,192.168.1.4,192.168.1.5,1274346276,193953450,4101,1,941485
545,1574590031.330894,192.168.1.4,192.168.1.5,3481414369,2784999114,16406,1,957891
546,1574590031.331011,192.168.1.4,192.168.1.5,3481430775,2784999114,15928,1,973819
547,1574590031.331121,192.168.1.4,192.168.1.5,3481446703,2784999114,17376,1,991195
548,1574590031.331216,192.168.1.4,192.168.1.5,3481464079,2784999114,15914,1,1007109
549,1574590031.331583,192.168.1.4,192.168.1.5,3481479993,2784999114,16406,1,1023515
550,1574590031.331814,192.168.1.4,192.168.1.5,3481496399,2784999114,13032,1,1036547
551,1574590031.332054,192.168.1.4,192.168.1.5,3481509431,2784999114,3374,1,1039921
552,1574590031.332082,192.168.1.4,192.168.1.5,3481512805,2784999114,3696,1,1043617
553,1574590031.332244,192.168.1.4,192.168.1.5,3481516501,2784999114,5694,1,1049311
554,1574590031.350308,192.168.1.4,192.168.1.5,3481522195,2784999114,14480,1,1063791
555,1574590031.35054,192.168.1.4,192.168.1.5,3481536675,2784999114,1926,1,1065717
556,1574590031.350575,192.168.1.4,192.168.1.5,3481538601,2784999114,16406,1,1082123
557,1574590031.350663,192.168.1.4,192.168.1.5,3481555007,2784999114,14480,1,1096603
558,1574590031.350811,192.168.1.4,192.168.1.5,3481569487,2784999114,7240,1,1103843
559,1574590031.350861,192.168.1.4,192.168.1.5,3481576727,2784999114,10136,1,1113979
560,1574590031.350876,192.168.1.4,192.168.1.5,3481586863,2784999114,2836,1,1116815
561,1574590031.378767,192.168.1.4,192.168.1.5,3481589699,2784999114,16406,1,1133221
562,1574590031.378872,192.168.1.4,192.168.1.5,3481606105,2784999114,16406,1,1149627
563,1574590031.379118,192.168.1.4,192.168.1.5,3481622511,2784999114,11584,1,1161211
564,1574590031.37919,192.168.1.4,192.168.1.5,3481634095,2784999114,4822,1,1166033
565,1574590031.379208,192.168.1.4,192.168.1.5,3481638917,2784999114,16353,1,1182386
566,1574590031.379339,192.168.1.4,192.168.1.5,3481655270,2784999114,1343,1,1183729
567,1574590031.406491,192.168.1.4,192.168.1.5,3481656613,2784999114,16406,1,1200135
568,1574590031.406583,192.168.1.4,192.168.1.5,3481673019,2784999114,16406,1,1216541
569,1574590031.4067,192.168.1.4,192.168.1.5,3481689425,2784999114,21720,1,1238261
570,1574590031.406963,192.168.1.4,192.168.1.5,3481711145,2784999114,12066,1,1250327
571,1574590031.450734,192.168.1.4,192.168.1.5,3481723211,2784999114,16406,1,1266733
572,1574590031.450885,192.168.1.4,192.168.1.5,3481739617,2784999114,16406,1,1283139
573,1574590031.45091,192.168.1.4,192.168.1.5,3481756023,2784999114,1444,1,1284583
574,1574590031.467372,192.168.1.4,192.168.1.5,3481757467,2784999114,2070,1,1286653
575,1574590031.467441,192.168.1.4,192.168.1.5,3481759537,2784999114,2070,1,1288723
576,1574590031.468194,192.168.1.4,192.168.1.5,3481761607,2784999114,2070,1,1290793
577,1574590031.468226,192.168.1.4,192.168.1.5,3481763677,2784999114,2070,1,1292863
578,1574590031.468234,192.168.1.4,192.168.1.5,3481765747,2784999114,1756,1,1294619
579,1574590031.471781,192.168.1.4,192.168.1.5,3481767503,2784999114,2070,1,1296689
580,1574590031.487615,192.168.1.4,192.168.1.5,3481769573,2784999114,16406,1,1313095
581,1574590031.487697,192.168.1.4,192.168.1.5,3481785979,2784999114,16406,1,1329501
582,1574590031.48773,192.168.1.4,192.168.1.5,3481802385,2784999114,5792,1,1335293
583,1574590031.48796,192.168.1.4,192.168.1.5,3481808177,2784999114,11584,1,1346877
584,1574590031.48814,192.168.1.4,192.168.1.5,3481819761,2784999114,15383,1,1362260
585,1574590031.488155,192.168.1.4,192.168.1.5,3481835144,2784999114,5123,1,1367383
586,1574590031.505796,192.168.1.4,192.168.1.5,3481840267,2784999114,16406,1,1383789
587,1574590031.505915,192.168.1.4,192.168.1.5,3481856673,2784999114,16406,1,1400195
588,1574590031.505959,192.168.1.4,192.168.1.5,3481873079,2784999114,8688,1,1408883
589,1574590031.506041,192.168.1.4,192.168.1.5,3481881767,2784999114,7718,1,1416601
590,1574590031.506073,192.168.1.4,192.168.1.5,3481889485,2784999114,2896,1,1419497
591,1574590031.506657,192.168.1.4,192.168.1.5,3481892381,2784999114,5792,1,1425289
592,1574590031.508208,192.168.1.4,192.168.1.5,3481898173,2784999114,14116,1,1439405
593,1574590031.522883,192.168.1.4,192.168.1.5,3481912289,2784999114,16406,1,1455811
594,1574590031.523003,192.168.1.4,192.168.1.5,3481928695,2784999114,16406,1,1472217
595,1574590031.523112,192.168.1.4,192.168.1.5,3481945101,2784999114,11584,1,1483801
596,1574590031.523168,192.168.1.4,192.168.1.5,3481956685,2784999114,17376,1,1501177
597,1574590031.523398,192.168.1.4,192.168.1.5,3481974061,2784999114,4668,1,1505845
598,1574590031.523557,192.168.1.4,192.168.1.5,3481978729,2784999114,4140,1,1509985
599,1574590031.540285,192.168.1.4,192.168.1.5,3481982869,2784999114,16406,1,1526391
600,1574590031.540391,192.168.1.4,192.168.1.5,3481999275,2784999114,16406,1,1542797
601,1574590031.540447,192.168.1.4,192.168.1.5,3482015681,2784999114,14480,1,1557277
602,1574590031.54047,192.168.1.4,192.168.1.5,3482030161,2784999114,18279,1,1575556
603,1574590031.540742,192.168.1.4,192.168.1.5,3482048440,2784999114,399,1,1575955
604,1574590031.541245,192.168.1.4,192.168.1.5,3482048839,2784999114,2070,1,1578025
605,1574590031.543015,192.168.1.4,192.168.1.5,3482050909,2784999114,810,1,1578835
606,1574590031.544192,192.168.1.4,192.168.1.5,3482051719,2784999114,2070,1,1580905
607,1574590031.544373,192.168.1.4,192.168.1.5,3482053789,2784999114,2070,1,1582975
608,1574590031.586304,192.168.1.4,192.168.1.5,3482055859,2784999114,16406,1,1599381
609,1574590031.58638,192.168.1.4,192.168.1.5,3482072265,2784999114,16406,1,1615787
610,1574590031.586524,192.168.1.4,192.168.1.5,3482088671,2784999114,16406,1,1632193
611,1574590031.58684,192.168.1.4,192.168.1.5,3482105077,2784999114,10584,1,1642777
612,1574590031.636813,192.168.1.4,192.168.1.5,3482115661,2784999114,1440,1,1644217
613,1574590031.637456,192.168.1.4,192.168.1.5,3482117101,2784999114,2070,1,1646287
614,1574590031.637735,192.168.1.4,192.168.1.5,3482119171,2784999114,810,1,1647097
615,1574590031.638157,192.168.1.4,192.168.1.5,3482119981,2784999114,2070,1,1649167
616,1574590031.638354,192.168.1.4,192.168.1.5,3482122051,2784999114,810,1,1649977
617,1574590031.639109,192.168.1.4,192.168.1.5,3482122861,2784999114,2070,1,1652047
618,1574590031.639335,192.168.1.4,192.168.1.5,3482124931,2784999114,810,1,1652857
619,1574590031.640042,192.168.1.4,192.168.1.5,3482125741,2784999114,2070,1,1654927
620,1574590031.640365,192.168.1.4,192.168.1.5,3482127811,2784999114,2070,1,1656997
621,1574590031.645794,192.168.1.5,192.168.1.4,193953450,1274350377,109,0,1656888
622,1574590031.656809,192.168.1.4,192.168.1.5,3482129881,2784999114,16406,1,1673294
623,1574590031.657158,192.168.1.4,192.168.1.5,3482146287,2784999114,16406,1,1689700
624,1574590031.657249,192.168.1.4,192.168.1.5,3482162693,2784999114,16406,1,1706106
625,1574590031.657299,192.168.1.4,192.168.1.5,3482179099,2784999114,16353,1,1722459
626,1574590031.657317,192.168.1.4,192.168.1.5,3482195452,2784999114,397,1,1722856
627,1574590031.657435,192.168.1.4,192.168.1.5,3482195849,2784999114,2070,1,1724926
628,1574590031.657606,192.168.1.4,192.168.1.5,3482197919,2784999114,2070,1,1726996
629,1574590031.667102,192.168.1.4,192.168.1.5,3482199989,2784999114,16406,1,1743402
630,1574590031.667207,192.168.1.4,192.168.1.5,3482216395,2784999114,16406,1,1759808
631,1574590031.667378,192.168.1.4,192.168.1.5,3482232801,2784999114,16406,1,1776214
632,1574590031.667478,192.168.1.4,192.168.1.5,3482249207,2784999114,16353,1,1792567
633,1574590031.667647,192.168.1.4,192.168.1.5,3482265560,2784999114,713,1,1793280
634,1574590031.668143,192.168.1.4,192.168.1.5,3482266273,2784999114,3668,1,1796948
635,1574590031.668319,192.168.1.4,192.168.1.5,3482269941,2784999114,810,1,1797758
636,1574590031.668849,192.168.1.4,192.168.1.5,3482270751,2784999114,1440,1,1799198
637,1574590031.670023,192.168.1.4,192.168.1.5,3482272191,2784999114,1440,1,1800638
638,1574590031.67225,192.168.1.4,192.168.1.5,715771215,1364498823,91,1,1800729
639,1574590031.672353,192.168.1.4,192.168.1.5,193724570,2394595669,91,1,1800820
640,1574590031.672432,192.168.1.4,192.168.1.5,3591080055,388163211,91,1,1800911
641,1574590031.672516,192.168.1.4,192.168.1.5,3591080146,388163211,24,1,1800935
642,1574590031.673214,192.168.1.4,192.168.1.5,193724661,2394595669,24,1,1800959
643,1574590031.673733,192.168.1.4,192.168.1.5,715771306,1364498824,24,1,1800983
644,1574590031.689005,192.168.1.4,192.168.1.5,3482273631,2784999114,16406,1,1817389
645,1574590031.689074,192.168.1.4,192.168.1.5,3482290037,2784999114,16406,1,1833795
646,1574590031.689182,192.168.1.4,192.168.1.5,3482306443,2784999114,16406,1,1850201
647,1574590031.689424,192.168.1.4,192.168.1.5,3482322849,2784999114,11584,1,1861785
648,1574590031.690077,192.168.1.4,192.168.1.5,3482334433,2784999114,8834,1,1870619
649,1574590031.690304,192.168.1.4,192.168.1.5,3482343267,2784999114,2070,1,1872689
650,1574590031.690314,192.168.1.4,192.168.1.5,3482345337,2784999114,2070,1,1874759
651,1574590031.701537,192.168.1.4,192.168.1.5,3482347407,2784999114,16406,1,1891165
652,1574590031.701764,192.168.1.4,192.168.1.5,3482363813,2784999114,16406,1,1907571
653,1574590031.701813,192.168.1.4,192.168.1.5,3482380219,2784999114,16406,1,1923977
654,1574590031.701936,192.168.1.4,192.168.1.5,3482396625,2784999114,2896,1,1926873
655,1574590031.70195,192.168.1.4,192.168.1.5,3482399521,2784999114,13457,1,1940330
656,1574590031.702135,192.168.1.4,192.168.1.5,3482412978,2784999114,711,1,1941041
657,1574590031.702312,192.168.1.4,192.168.1.5,3482413689,2784999114,2070,1,1943111
658,1574590031.702917,192.168.1.4,192.168.1.5,3482415759,2784999114,2070,1,1945181
659,1574590031.704319,192.168.1.4,192.168.1.5,1274350377,193953559,151,1,1945332
660,1574590031.706479,192.168.1.4,192.168.1.5,1274350528,193953559,2070,1,1947402
661,1574590031.706738,192.168.1.4,192.168.1.5,1274352598,193953559,2070,1,1949472
662,1574590031.706857,192.168.1.4,192.168.1.5,1274354668,193953559,1530,1,1951002
663,1574590031.714542,192.168.1.5,192.168.1.4,193953559,1274356198,61,0,1950941
664,1574590031.724012,192.168.1.4,192.168.1.5,3482417829,2784999114,16406,1,1967347
665,1574590031.724184,192.168.1.4,192.168.1.5,3482434235,2784999114,16406,1,1983753
666,1574590031.724335,192.168.1.4,192.168.1.5,3482450641,2784999114,16406,1,2000159
667,1574590031.724694,192.168.1.4,192.168.1.5,3482467047,2784999114,16353,1,2016512
668,1574590031.724876,192.168.1.4,192.168.1.5,3482483400,2784999114,557,1,2017069
669,1574590031.725162,192.168.1.4,192.168.1.5,3482483957,2784999114,2070,1,2019139
670,1574590031.725195,192.168.1.4,192.168.1.5,3482486027,2784999114,810,1,2019949
671,1574590031.727946,192.168.1.4,192.168.1.5,3482486837,2784999114,2070,1,2022019
672,1574590031.728233,192.168.1.4,192.168.1.5,3482488907,2784999114,2070,1,2024089
673,1574590031.756169,192.168.1.4,192.168.1.5,3482490977,2784999114,16406,1,2040495
674,1574590031.756632,192.168.1.4,192.168.1.5,3482507383,2784999114,16406,1,2056901
675,1574590031.756878,192.168.1.4,192.168.1.5,3482523789,2784999114,16406,1,2073307
676,1574590031.756979,192.168.1.4,192.168.1.5,3482540195,2784999114,16353,1,2089660
677,1574590031.756998,192.168.1.4,192.168.1.5,3482556548,2784999114,1027,1,2090687
678,1574590031.757489,192.168.1.4,192.168.1.5,3482557575,2784999114,2070,1,2092757
679,1574590031.757681,192.168.1.4,192.168.1.5,3482559645,2784999114,2070,1,2094827
680,1574590031.76449,192.168.1.5,192.168.1.4,2784999114,3482561715,68,0,2094759
681,1574590031.764999,192.168.1.4,192.168.1.5,3482561715,2784999182,7056,1,2101815
682,1574590033.242977,192.168.1.4,192.168.1.5,2122214492,2414051718,91,1,2101906
683,1574590033.243,192.168.1.4,192.168.1.5,2122214583,2414051718,24,1,2101930
684,1574590033.905811,192.168.1.4,192.168.1.5,1420203980,4252984648,91,1,2102021
685,1574590033.906109,192.168.1.4,192.168.1.5,1420204071,4252984648,24,1,2102045
686,1574590034.873016,192.168.1.4,192.168.1.5,3139665817,2360122134,91,1,2102136
687,1574590034.873087,192.168.1.4,192.168.1.5,2373818650,1778739461,91,1,2102227
688,1574590034.873099,192.168.1.4,192.168.1.5,2373818741,1778739461,24,1,2102251
689,1574590034.87467,192.168.1.5,192.168.1.4,2360122134,3139665908,539,0,2101712
690,1574590034.922151,192.168.1.4,192.168.1.5,3139665908,2360122673,2070,1,2103782
691,1574590034.962339,192.168.1.4,192.168.1.5,3139667978,2360122673,1249,1,2105031
692,1574590034.974009,192.168.1.5,192.168.1.4,2360122673,3139669227,86,0,2104945
693,1574590034.974913,192.168.1.5,192.168.1.4,2360122759,3139669227,108,0,2104837
694,1574590034.9765,192.168.1.5,192.168.1.4,2360122867,3139669227,259,0,2104578
695,1574590035.027168,192.168.1.4,192.168.1.5,3139669227,2360123126,2070,1,2106648
696,1574590035.033792,192.168.1.5,192.168.1.4,2360123126,3139671297,53,0,2106595
697,1574590035.03425,192.168.1.4,192.168.1.5,3139671297,2360123179,5792,1,2112387
698,1574590035.034342,192.168.1.4,192.168.1.5,3139677089,2360123179,8688,1,2121075
699,1574590035.034525,192.168.1.4,192.168.1.5,3139685777,2360123179,5792,1,2126867
700,1574590035.03465,192.168.1.4,192.168.1.5,3139691569,2360123179,29,1,2126896
701,1574590035.078286,192.168.1.4,192.168.1.5,3139691598,2360123179,2858,1,2129754
702,1574590035.085238,192.168.1.4,192.168.1.5,3139694456,2360123179,1164,1,2130918
703,1574590035.085921,192.168.1.5,192.168.1.4,2360123179,3139695620,61,0,2130857
704,1574590035.145173,192.168.1.5,192.168.1.4,462942555,4075095385,24,0,2130833
705,1574590035.145712,192.168.1.4,192.168.1.5,4075095385,462942580,24,1,2130857
706,1574590035.147052,192.168.1.5,192.168.1.4,3450715332,858725637,343,0,2130514
707,1574590035.147537,192.168.1.4,192.168.1.5,858725637,3450715675,99,1,2130613
708,1574590035.147832,192.168.1.5,192.168.1.4,3450715675,858725736,382,0,2130231
709,1574590035.153626,192.168.1.5,192.168.1.4,1391662367,798157848,343,0,2129888
710,1574590035.157645,192.168.1.4,192.168.1.5,858725736,3450716057,2266,1,2132154
711,1574590035.158231,192.168.1.4,192.168.1.5,798157848,1391662710,99,1,2132253
712,1574590035.158686,192.168.1.5,192.168.1.4,3450716057,858728002,74,0,2132179
713,1574590035.158819,192.168.1.5,192.168.1.4,3450716131,858728002,255,0,2131924
714,1574590035.159039,192.168.1.4,192.168.1.5,858728002,3450716386,79,1,2132003
715,1574590035.159143,192.168.1.5,192.168.1.4,1391662710,798157947,382,0,2131621
716,1574590035.159188,192.168.1.4,192.168.1.5,858728081,3450716386,79,1,2131700
717,1574590035.170103,192.168.1.4,192.168.1.5,798157947,1391663092,2266,1,2133966
718,1574590035.171092,192.168.1.5,192.168.1.4,1391663092,798160213,74,0,2133892
719,1574590035.171199,192.168.1.5,192.168.1.4,1391663166,798160213,251,0,2133641
720,1574590035.171431,192.168.1.4,192.168.1.5,798160213,1391663417,79,1,2133720
721,1574590035.173028,192.168.1.4,192.168.1.5,798160292,1391663417,79,1,2133799
722,1574590035.23629,192.168.1.4,192.168.1.5,715838768,221768715,91,1,2133890
723,1574590035.243318,192.168.1.5,192.168.1.4,221768715,715838859,566,0,2133324
724,1574590035.245469,192.168.1.5,192.168.1.4,3765329003,2596619181,343,0,2132981
725,1574590035.245992,192.168.1.4,192.168.1.5,2596619181,3765329346,99,1,2133080
726,1574590035.246428,192.168.1.5,192.168.1.4,3765329346,2596619280,382,0,2132698
727,1574590035.261437,192.168.1.4,192.168.1.5,2596619280,3765329728,2266,1,2134964
728,1574590035.262383,192.168.1.5,192.168.1.4,3765329728,2596621546,74,0,2134890
729,1574590035.262516,192.168.1.5,192.168.1.4,3765329802,2596621546,170,0,2134720
730,1574590035.262815,192.168.1.4,192.168.1.5,2596621546,3765329972,79,1,2134799
731,1574590035.26304,192.168.1.4,192.168.1.5,2596621625,3765329972,79,1,2134878
732,1574590035.448959,192.168.1.4,192.168.1.5,715838859,221769281,178,1,2135056
733,1574590035.450265,192.168.1.5,192.168.1.4,221769281,715839037,73,0,2134983
734,1574590035.480874,192.168.1.4,192.168.1.5,715839037,221769354,91,1,2135074
735,1574590037.231987,192.168.1.4,192.168.1.5,374507992,3575604582,91,1,2135165
736,1574590037.232713,192.168.1.5,192.168.1.4,3575604582,374508083,566,0,2134599
737,1574590037.267648,192.168.1.4,192.168.1.5,374508083,3575605148,178,1,2134777
738,1574590037.268647,192.168.1.5,192.168.1.4,3575605148,374508261,73,0,2134704
739,1574590037.305405,192.168.1.4,192.168.1.5,374508261,3575605221,91,1,2134795
740,1574590039.755795,192.168.1.4,192.168.1.5,876319466,3708741530,91,1,2134886
741,1574590039.756074,192.168.1.4,192.168.1.5,876319557,3708741530,24,1,2134910
742,1574590040.273659,192.168.1.4,192.168.1.5,2199846875,134047976,91,1,2135001
743,1574590040.273802,192.168.1.4,192.168.1.5,517174136,2955201002,91,1,2135092
744,1574590040.273905,192.168.1.4,192.168.1.5,3513882201,4115070077,91,1,2135183
745,1574590040.27401,192.168.1.4,192.168.1.5,517174227,2955201002,24,1,2135207
746,1574590040.275083,192.168.1.4,192.168.1.5,2199846966,134047977,24,1,2135231
747,1574590040.276059,192.168.1.4,192.168.1.5,3513882292,4115070078,24,1,2135255
748,1574590040.838925,192.168.1.4,192.168.1.5,798160371,1391663417,91,1,2135346
749,1574590040.842822,192.168.1.5,192.168.1.4,1391663417,798160462,539,0,2134807
750,1574590040.888691,192.168.1.4,192.168.1.5,798160462,1391663956,2070,1,2136877
751,1574590040.930369,192.168.1.4,192.168.1.5,798162532,1391663956,1429,1,2138306
752,1574590040.932519,192.168.1.5,192.168.1.4,1391663956,798163961,86,0,2138220
753,1574590040.934389,192.168.1.5,192.168.1.4,1391664042,798163961,108,0,2138112
754,1574590040.935216,192.168.1.5,192.168.1.4,1391664150,798163961,289,0,2137823
755,1574590040.979125,192.168.1.4,192.168.1.5,798163961,1391664439,2070,1,2139893
756,1574590040.980557,192.168.1.5,192.168.1.4,1391664439,798166031,53,0,2139840
757,1574590040.980931,192.168.1.4,192.168.1.5,798166031,1391664492,7240,1,2147080
758,1574590040.981057,192.168.1.4,192.168.1.5,798173271,1391664492,7240,1,2154320
759,1574590040.981192,192.168.1.4,192.168.1.5,798180511,1391664492,105,1,2154425
760,1574590040.981915,192.168.1.5,192.168.1.4,1391664492,798180616,61,0,2154364
761,1574590041.590675,192.168.1.4,192.168.1.5,3707289765,2334846867,91,1,2154455
762,1574590041.594088,192.168.1.5,192.168.1.4,2334846867,3707289856,539,0,2153916
763,1574590041.638467,192.168.1.4,192.168.1.5,3707289856,2334847406,2070,1,2155986
764,1574590041.682543,192.168.1.4,192.168.1.5,3707291926,2334847406,1755,1,2157741
765,1574590041.686024,192.168.1.5,192.168.1.4,2334847406,3707293681,86,0,2157655
766,1574590041.687079,192.168.1.5,192.168.1.4,2334847492,3707293681,108,0,2157547
767,1574590041.687407,192.168.1.5,192.168.1.4,2334847600,3707293681,279,0,2157268
768,1574590041.72304,192.168.1.4,192.168.1.5,3707293681,2334847879,954,1,2158222
769,1574590041.724049,192.168.1.5,192.168.1.4,2334847879,3707294635,53,0,2158169
770,1574590041.724428,192.168.1.4,192.168.1.5,3707294635,2334847932,2521,1,2160690
771,1574590041.725071,192.168.1.5,192.168.1.4,2334847932,3707297156,61,0,2160629
772,1574590041.946627,192.168.1.4,192.168.1.5,858728160,3450716386,91,1,2160720
773,1574590041.946661,192.168.1.4,192.168.1.5,1964329070,553531074,91,1,2160811
774,1574590041.947112,192.168.1.4,192.168.1.5,1964329161,553531074,24,1,2160835
775,1574590041.948151,192.168.1.5,192.168.1.4,3450716386,858728251,539,0,2160296
776,1574590041.992921,192.168.1.4,192.168.1.5,858728251,3450716925,2070,1,2162366
777,1574590042.034392,192.168.1.4,192.168.1.5,858730321,3450716925,1249,1,2163615
778,1574590042.036731,192.168.1.5,192.168.1.4,3450716925,858731570,86,0,2163529
779,1574590042.037065,192.168.1.5,192.168.1.4,3450717011,858731570,108,0,2163421
780,1574590042.037891,192.168.1.5,192.168.1.4,3450717119,858731570,250,0,2163171
781,1574590042.073209,192.168.1.4,192.168.1.5,858731570,3450717369,2070,1,2165241
782,1574590042.075785,192.168.1.5,192.168.1.4,3450717369,858733640,53,0,2165188
783,1574590042.076516,192.168.1.4,192.168.1.5,858733640,3450717422,7240,1,2172428
784,1574590042.076798,192.168.1.4,192.168.1.5,858740880,3450717422,4448,1,2176876
785,1574590042.118205,192.168.1.4,192.168.1.5,858745328,3450717422,5406,1,2182282
786,1574590042.121889,192.168.1.5,192.168.1.4,3450717422,858750734,61,0,2182221
787,1574590042.170955,192.168.1.5,192.168.1.4,3450717483,858750734,417,0,2181804
788,1574590042.18189,192.168.1.5,192.168.1.4,3450717900,858750734,415,0,2181389
789,1574590042.208435,192.168.1.4,192.168.1.5,858750734,3450718315,867,1,2182256
790,1574590042.209135,192.168.1.5,192.168.1.4,3450718315,858751601,61,0,2182195
791,1574590042.215154,192.168.1.4,192.168.1.5,858751601,3450718376,199,1,2182394
792,1574590042.219595,192.168.1.5,192.168.1.4,1267634734,2488359969,343,0,2182051
793,1574590042.219992,192.168.1.4,192.168.1.5,2488359969,1267635077,99,1,2182150
794,1574590042.220281,192.168.1.5,192.168.1.4,1267635077,2488360068,382,0,2181768
795,1574590042.230838,192.168.1.4,192.168.1.5,2488360068,1267635459,2266,1,2184034
796,1574590042.231718,192.168.1.5,192.168.1.4,1267635459,2488362334,74,0,2183960
797,1574590042.231832,192.168.1.5,192.168.1.4,1267635533,2488362334,253,0,2183707
798,1574590042.232131,192.168.1.4,192.168.1.5,2488362334,1267635786,79,1,2183786
799,1574590042.232161,192.168.1.4,192.168.1.5,2488362413,1267635786,79,1,2183865
800,1574590043.037887,192.168.1.4,192.168.1.5,2596621704,3765329972,670,1,2184535
801,1574590043.037919,192.168.1.4,192.168.1.5,2596622374,3765329972,24,1,2184559
802,1574590043.038588,192.168.1.5,192.168.1.4,3765329972,2596622398,24,0,2184535
803,1574590043.041738,192.168.1.5,192.168.1.4,770450543,3492357701,343,0,2184192
804,1574590043.042291,192.168.1.4,192.168.1.5,3492357701,770450886,99,1,2184291
805,1574590043.04255,192.168.1.5,192.168.1.4,770450886,3492357800,382,0,2183909
806,1574590043.052246,192.168.1.4,192.168.1.5,3492357800,770451268,2266,1,2186175
807,1574590043.053146,192.168.1.5,192.168.1.4,770451268,3492360066,74,0,2186101
808,1574590043.053256,192.168.1.5,192.168.1.4,770451342,3492360066,170,0,2185931
809,1574590043.053558,192.168.1.4,192.168.1.5,3492360066,770451512,79,1,2186010
810,1574590043.053575,192.168.1.4,192.168.1.5,3492360145,770451512,79,1,2186089
811,1574590044.905779,192.168.1.4,192.168.1.5,2488362492,1267635786,91,1,2186180
812,1574590044.906404,192.168.1.5,192.168.1.4,1267635786,2488362583,539,0,2185641
813,1574590044.945006,192.168.1.4,192.168.1.5,2488362583,1267636325,2070,1,2187711
814,1574590044.986329,192.168.1.4,192.168.1.5,2488364653,1267636325,810,1,2188521
815,1574590044.988836,192.168.1.5,192.168.1.4,1267636325,2488365463,86,0,2188435
816,1574590044.989068,192.168.1.5,192.168.1.4,1267636411,2488365463,108,0,2188327
817,1574590044.992106,192.168.1.5,192.168.1.4,1267636519,2488365463,377,0,2187950
818,1574590045.026472,192.168.1.4,192.168.1.5,2488365463,1267636896,617,1,2188567
819,1574590045.026948,192.168.1.5,192.168.1.4,1267636896,2488366080,53,0,2188514
820,1574590045.029362,192.168.1.4,192.168.1.5,2488366080,1267636949,398,1,2188912
821,1574590045.070509,192.168.1.4,192.168.1.5,2488366478,1267636949,158,1,2189070
822,1574590045.071294,192.168.1.5,192.168.1.4,1267636949,2488366636,61,0,2189009
823,1574590045.741334,192.168.1.4,192.168.1.5,3492360224,770451512,670,1,2189679
824,1574590045.741485,192.168.1.4,192.168.1.5,3492360894,770451512,24,1,2189703
825,1574590045.743641,192.168.1.5,192.168.1.4,770451512,3492360918,24,0,2189679
826,1574590045.754022,192.168.1.5,192.168.1.4,899961668,395238329,343,0,2189336
827,1574590045.754405,192.168.1.4,192.168.1.5,395238329,899962011,99,1,2189435
828,1574590045.75488,192.168.1.5,192.168.1.4,899962011,395238428,382,0,2189053
829,1574590045.770007,192.168.1.4,192.168.1.5,395238428,899962393,2266,1,2191319
830,1574590045.770927,192.168.1.5,192.168.1.4,899962393,395240694,74,0,2191245
831,1574590045.77111,192.168.1.5,192.168.1.4,899962467,395240694,170,0,2191075
832,1574590045.771303,192.168.1.4,192.168.1.5,395240694,899962637,79,1,2191154
833,1574590045.771387,192.168.1.4,192.168.1.5,395240773,899962637,79,1,2191233
834,1574590046.654825,192.168.1.4,192.168.1.5,395240852,899962637,670,1,2191903
835,1574590046.654854,192.168.1.4,192.168.1.5,395241522,899962637,24,1,2191927
836,1574590046.655467,192.168.1.5,192.168.1.4,899962637,395241546,24,0,2191903
837,1574590046.665201,192.168.1.5,192.168.1.4,927514668,3317553761,343,0,2191560
838,1574590046.6655,192.168.1.4,192.168.1.5,3317553761,927515011,99,1,2191659
839,1574590046.66611,192.168.1.5,192.168.1.4,927515011,3317553860,382,0,2191277
840,1574590046.675977,192.168.1.4,192.168.1.5,3317553860,927515393,2266,1,2193543
841,1574590046.676848,192.168.1.5,192.168.1.4,927515393,3317556126,74,0,2193469
842,1574590046.676983,192.168.1.5,192.168.1.4,927515467,3317556126,170,0,2193299
843,1574590046.677199,192.168.1.4,192.168.1.5,3317556126,927515637,79,1,2193378
844,1574590046.680656,192.168.1.4,192.168.1.5,3317556205,927515637,79,1,2193457
845,1574590047.623366,192.168.1.4,192.168.1.5,3317556284,927515637,670,1,2194127
846,1574590047.623394,192.168.1.4,192.168.1.5,3317556954,927515637,24,1,2194151
847,1574590047.624126,192.168.1.5,192.168.1.4,927515637,3317556978,24,0,2194127
848,1574590047.627573,192.168.1.5,192.168.1.4,3736329181,1942945645,343,0,2193784
849,1574590047.627934,192.168.1.4,192.168.1.5,1942945645,3736329524,99,1,2193883
850,1574590047.62833,192.168.1.5,192.168.1.4,3736329524,1942945744,382,0,2193501
851,1574590047.639004,192.168.1.4,192.168.1.5,1942945744,3736329906,2266,1,2195767
852,1574590047.639907,192.168.1.5,192.168.1.4,3736329906,1942948010,74,0,2195693
853,1574590047.640048,192.168.1.5,192.168.1.4,3736329980,1942948010,170,0,2195523
854,1574590047.640308,192.168.1.4,192.168.1.5,1942948010,3736330150,79,1,2195602
855,1574590047.640387,192.168.1.4,192.168.1.5,1942948089,3736330150,79,1,2195681
856,1574590048.557796,192.168.1.4,192.168.1.5,1942948168,3736330150,670,1,2196351
857,1574590048.557825,192.168.1.4,192.168.1.5,1942948838,3736330150,24,1,2196375
858,1574590048.563435,192.168.1.5,192.168.1.4,3736330150,1942948862,24,0,2196351
859,1574590048.675052,192.168.1.5,192.168.1.4,229674519,4271810596,24,0,2196327
860,1574590048.675731,192.168.1.4,192.168.1.5,4271810596,229674543,24,1,2196351
861,1574590048.677623,192.168.1.5,192.168.1.4,3999383846,1802498956,24,0,2196327
862,1574590048.678041,192.168.1.5,192.168.1.4,2345994182,4290425473,24,0,2196303
863,1574590048.678148,192.168.1.4,192.168.1.5,1802498956,3999383870,24,1,2196327
864,1574590048.678417,192.168.1.4,192.168.1.5,4290425473,2345994206,24,1,2196351
865,1574590048.679888,192.168.1.5,192.168.1.4,2363862131,1269138047,24,0,2196327
866,1574590048.680115,192.168.1.5,192.168.1.4,1142676598,1395280397,24,0,2196303
867,1574590048.680307,192.168.1.5,192.168.1.4,1391664553,798180616,24,0,2196279
868,1574590048.680347,192.168.1.4,192.168.1.5,1269138047,2363862155,24,1,2196303
869,1574590048.680841,192.168.1.5,192.168.1.4,1267637010,2488366636,24,0,2196279
870,1574590048.681159,192.168.1.5,192.168.1.4,2360123240,3139695620,24,0,2196255
871,1574590048.681316,192.168.1.4,192.168.1.5,798180616,1391664577,24,1,2196279
872,1574590048.681592,192.168.1.4,192.168.1.5,2488366636,1267637034,24,1,2196303
873,1574590048.681722,192.168.1.4,192.168.1.5,3139695620,2360123264,24,1,2196327
874,1574590048.681796,192.168.1.4,192.168.1.5,1395280397,1142676622,24,1,2196351
875,1574590048.683278,192.168.1.5,192.168.1.4,193953620,1274356198,24,0,2196327
876,1574590048.683457,192.168.1.5,192.168.1.4,613188537,403861301,24,0,2196303
877,1574590048.683543,192.168.1.5,192.168.1.4,2784999182,3482568771,24,0,2196279
878,1574590048.683653,192.168.1.5,192.168.1.4,3450718376,858751800,24,0,2196255
879,1574590048.683737,192.168.1.5,192.168.1.4,3999487986,1347512977,24,0,2196231
880,1574590048.683838,192.168.1.5,192.168.1.4,221769354,715839128,24,0,2196207
881,1574590048.684616,192.168.1.4,192.168.1.5,1347512977,3999488010,24,1,2196231
882,1574590048.684714,192.168.1.4,192.168.1.5,403861301,613188561,24,1,2196255
883,1574590048.684876,192.168.1.4,192.168.1.5,3482568771,2784999206,24,1,2196279
884,1574590048.68498,192.168.1.4,192.168.1.5,715839128,221769379,24,1,2196303
885,1574590048.685139,192.168.1.5,192.168.1.4,3575605221,374508352,24,0,2196279
886,1574590048.685205,192.168.1.4,192.168.1.5,858751800,3450718400,24,1,2196303
887,1574590048.685234,192.168.1.4,192.168.1.5,1274356198,193953644,24,1,2196327
888,1574590048.685781,192.168.1.4,192.168.1.5,374508352,3575605246,24,1,2196351
889,1574590048.701128,192.168.1.5,192.168.1.4,2334847993,3707297156,24,0,2196327
890,1574590048.701862,192.168.1.4,192.168.1.5,3707297156,2334848017,24,1,2196351
