index,time,src_ip,dst_ip,tcp_seq,tcp_ack,tcp_len,direction,cumul_sum
1,1574590234.308984,192.168.1.4,192.168.1.5,1545393550,1753184458,91,1,91
2,1574590234.309006,192.168.1.4,192.168.1.5,1545393641,1753184458,24,1,115
3,1574590235.277652,192.168.1.4,192.168.1.5,3559352270,3240271972,91,1,206
4,1574590235.277772,192.168.1.4,192.168.1.5,3559352361,3240271972,24,1,230
5,1574590236.576728,192.168.1.4,192.168.1.5,1038766276,4025303269,91,1,321
6,1574590236.577049,192.168.1.4,192.168.1.5,1038766367,4025303269,24,1,345
7,1574590236.704465,192.168.1.4,192.168.1.5,3156380146,458742100,91,1,436
8,1574590236.704694,192.168.1.4,192.168.1.5,2232540183,4189463577,91,1,527
9,1574590236.704886,192.168.1.4,192.168.1.5,2232540274,4189463577,24,1,551
10,1574590236.705731,192.168.1.4,192.168.1.5,3156380237,458742101,24,1,575
11,1574590237.183808,192.168.1.4,192.168.1.5,809298356,328936488,91,1,666
12,1574590237.183907,192.168.1.4,192.168.1.5,809298447,328936488,24,1,690
13,1574590237.85986,192.168.1.4,192.168.1.5,147003350,1374558847,91,1,781
14,1574590237.860274,192.168.1.4,192.168.1.5,147003441,1374558847,24,1,805
15,1574590238.193817,192.168.1.4,192.168.1.5,4198716153,587345145,91,1,896
16,1574590238.194229,192.168.1.4,192.168.1.5,4198716244,587345145,24,1,920
17,1574590238.196556,192.168.1.4,192.168.1.5,4239773769,1776212554,91,1,1011
18,1574590238.197043,192.168.1.4,192.168.1.5,4239773860,1776212554,24,1,1035
19,1574590239.075783,192.168.1.4,192.168.1.5,587804491,814896250,91,1,1126
20,1574590239.076049,192.168.1.4,192.168.1.5,587804582,814896250,24,1,1150
21,1574590240.405254,192.168.1.5,192.168.1.4,1706370148,2536152832,343,0,807
22,1574590240.406007,192.168.1.4,192.168.1.5,2536152832,1706370491,99,1,906
23,1574590240.406726,192.168.1.5,192.168.1.4,1706370491,2536152931,382,0,524
24,1574590240.418758,192.168.1.4,192.168.1.5,2536152931,1706370873,2266,1,2790
25,1574590240.419713,192.168.1.5,192.168.1.4,1706370873,2536155197,74,0,2716
26,1574590240.419855,192.168.1.5,192.168.1.4,1706370947,2536155197,245,0,2471
27,1574590240.420142,192.168.1.4,192.168.1.5,2536155197,1706371192,79,1,2550
28,1574590240.420213,192.168.1.4,192.168.1.5,2536155276,1706371192,79,1,2629
29,1574590240.557485,192.168.1.5,192.168.1.4,3745088686,2060083559,343,0,2286
30,1574590240.558242,192.168.1.4,192.168.1.5,2060083559,3745089029,99,1,2385
31,1574590240.558527,192.168.1.5,192.168.1.4,3745089029,2060083658,382,0,2003
32,1574590240.55939,192.168.1.5,192.168.1.4,2578220167,1442860848,343,0,1660
33,1574590240.562715,192.168.1.4,192.168.1.5,1442860848,2578220510,99,1,1759
34,1574590240.563008,192.168.1.5,192.168.1.4,2578220510,1442860947,382,0,1377
35,1574590240.576876,192.168.1.4,192.168.1.5,2060083658,3745089411,2266,1,3643
36,1574590240.577727,192.168.1.5,192.168.1.4,3745089411,2060085924,74,0,3569
37,1574590240.577838,192.168.1.5,192.168.1.4,3745089485,2060085924,227,0,3342
38,1574590240.578067,192.168.1.4,192.168.1.5,2060085924,3745089712,79,1,3421
39,1574590240.578984,192.168.1.4,192.168.1.5,2060086003,3745089712,79,1,3500
40,1574590240.579991,192.168.1.4,192.168.1.5,1442860947,2578220892,2266,1,5766
41,1574590240.580851,192.168.1.5,192.168.1.4,2578220892,1442863213,74,0,5692
42,1574590240.580965,192.168.1.5,192.168.1.4,2578220966,1442863213,227,0,5465
43,1574590240.581202,192.168.1.4,192.168.1.5,1442863213,2578221193,79,1,5544
44,1574590240.58127,192.168.1.4,192.168.1.5,1442863292,2578221193,79,1,5623
45,1574590243.801805,192.168.1.4,192.168.1.5,2536155355,1706371192,91,1,5714
46,1574590243.802546,192.168.1.5,192.168.1.4,1706371192,2536155446,539,0,5175
47,1574590243.841726,192.168.1.4,192.168.1.5,2536155446,1706371731,2070,1,7245
48,1574590243.88247,192.168.1.4,192.168.1.5,2536157516,1706371731,1018,1,8263
49,1574590243.897838,192.168.1.5,192.168.1.4,1706371731,2536158534,86,0,8177
50,1574590243.898249,192.168.1.5,192.168.1.4,1706371817,2536158534,108,0,8069
51,1574590243.898843,192.168.1.5,192.168.1.4,1706371925,2536158534,321,0,7748
52,1574590243.898994,192.168.1.5,192.168.1.4,1706372246,2536158534,54,0,7694
53,1574590243.933293,192.168.1.4,192.168.1.5,2536158534,1706372300,617,1,8311
54,1574590243.934027,192.168.1.5,192.168.1.4,1706372300,2536159151,53,0,8258
55,1574590243.943343,192.168.1.4,192.168.1.5,2536159151,1706372353,1376,1,9634
56,1574590243.949642,192.168.1.5,192.168.1.4,1706372353,2536160527,61,0,9573
57,1574590245.249328,192.168.1.4,192.168.1.5,1442863371,2578221193,91,1,9664
58,1574590245.249354,192.168.1.4,192.168.1.5,2060086082,3745089712,91,1,9755
59,1574590245.249732,192.168.1.5,192.168.1.4,3745089712,2060086173,539,0,9216
60,1574590245.249994,192.168.1.5,192.168.1.4,2578221193,1442863462,539,0,8677
61,1574590245.297903,192.168.1.4,192.168.1.5,1442863462,2578221732,2070,1,10747
62,1574590245.301149,192.168.1.4,192.168.1.5,2060086173,3745090251,2070,1,12817
63,1574590245.338293,192.168.1.4,192.168.1.5,1442865532,2578221732,1756,1,14573
64,1574590245.34217,192.168.1.4,192.168.1.5,2060088243,3745090251,1756,1,16329
65,1574590245.343941,192.168.1.5,192.168.1.4,2578221732,1442867288,86,0,16243
66,1574590245.345593,192.168.1.5,192.168.1.4,3745090251,2060089999,86,0,16157
67,1574590245.345894,192.168.1.5,192.168.1.4,3745090337,2060089999,24,0,16133
68,1574590245.346383,192.168.1.5,192.168.1.4,2578221818,1442867288,108,0,16025
69,1574590245.346445,192.168.1.4,192.168.1.5,2060089999,3745090361,24,1,16049
70,1574590245.348856,192.168.1.5,192.168.1.4,2578221926,1442867288,369,0,15680
71,1574590245.384562,192.168.1.4,192.168.1.5,1442867288,2578222295,1306,1,16986
72,1574590245.386485,192.168.1.5,192.168.1.4,2578222295,1442868594,53,0,16933
73,1574590245.386739,192.168.1.5,192.168.1.4,2578222348,1442868594,57,0,16876
74,1574590245.38688,192.168.1.5,192.168.1.4,2578222405,1442868594,61,0,16815
75,1574590245.39469,192.168.1.5,192.168.1.4,1220604523,872380951,343,0,16472
76,1574590245.395262,192.168.1.4,192.168.1.5,872380951,1220604866,99,1,16571
77,1574590245.395667,192.168.1.5,192.168.1.4,1220604866,872381050,382,0,16189
78,1574590245.410899,192.168.1.4,192.168.1.5,872381050,1220605248,2266,1,18455
79,1574590245.411831,192.168.1.5,192.168.1.4,1220605248,872383316,74,0,18381
80,1574590245.411954,192.168.1.5,192.168.1.4,1220605322,872383316,235,0,18146
81,1574590245.412188,192.168.1.4,192.168.1.5,872383316,1220605557,79,1,18225
82,1574590245.412261,192.168.1.4,192.168.1.5,872383395,1220605557,79,1,18304
83,1574590247.32256,192.168.1.4,192.168.1.5,872383474,1220605557,91,1,18395
84,1574590247.322983,192.168.1.5,192.168.1.4,1220605557,872383565,539,0,17856
85,1574590247.363172,192.168.1.4,192.168.1.5,872383565,1220606096,2070,1,19926
86,1574590247.406527,192.168.1.4,192.168.1.5,872385635,1220606096,598,1,20524
87,1574590247.409087,192.168.1.5,192.168.1.4,1220606096,872386233,86,0,20438
88,1574590247.409348,192.168.1.5,192.168.1.4,1220606182,872386233,108,0,20330
89,1574590247.409907,192.168.1.5,192.168.1.4,1220606290,872386233,373,0,19957
90,1574590247.448712,192.168.1.4,192.168.1.5,872386233,1220606663,617,1,20574
91,1574590247.449278,192.168.1.5,192.168.1.4,1220606663,872386850,53,0,20521
92,1574590247.454083,192.168.1.4,192.168.1.5,872386850,1220606716,2070,1,22591
93,1574590247.494303,192.168.1.4,192.168.1.5,872388920,1220606716,13026,1,35617
94,1574590247.495255,192.168.1.5,192.168.1.4,1220606716,872401946,61,0,35556
95,1574590247.515879,192.168.1.5,192.168.1.4,413629701,1256565957,343,0,35213
96,1574590247.516227,192.168.1.4,192.168.1.5,1256565957,413630044,99,1,35312
97,1574590247.516466,192.168.1.5,192.168.1.4,413630044,1256566056,382,0,34930
98,1574590247.518618,192.168.1.5,192.168.1.4,3391862198,1756047462,343,0,34587
99,1574590247.521582,192.168.1.5,192.168.1.4,1220606777,872401946,149,0,34438
100,1574590247.522883,192.168.1.4,192.168.1.5,1756047462,3391862541,99,1,34537
101,1574590247.523236,192.168.1.5,192.168.1.4,3391862541,1756047561,382,0,34155
102,1574590247.524207,192.168.1.5,192.168.1.4,1220606926,872401946,121,0,34034
103,1574590247.527551,192.168.1.5,192.168.1.4,1251731904,1549686739,343,0,33691
104,1574590247.530457,192.168.1.5,192.168.1.4,476500818,1188124861,343,0,33348
105,1574590247.534924,192.168.1.4,192.168.1.5,1188124861,476501161,99,1,33447
106,1574590247.535363,192.168.1.4,192.168.1.5,1549686739,1251732247,99,1,33546
107,1574590247.535652,192.168.1.5,192.168.1.4,1251732247,1549686838,382,0,33164
108,1574590247.535772,192.168.1.5,192.168.1.4,476501161,1188124960,382,0,32782
109,1574590247.552843,192.168.1.4,192.168.1.5,1756047561,3391862923,2266,1,35048
110,1574590247.554121,192.168.1.5,192.168.1.4,3391862923,1756049827,74,0,34974
111,1574590247.554303,192.168.1.5,192.168.1.4,3391862997,1756049827,247,0,34727
112,1574590247.568386,192.168.1.4,192.168.1.5,1256566056,413630426,2266,1,36993
113,1574590247.56965,192.168.1.5,192.168.1.4,413630426,1256568322,74,0,36919
114,1574590247.569922,192.168.1.5,192.168.1.4,413630500,1256568322,247,0,36672
115,1574590247.577217,192.168.1.5,192.168.1.4,3391862997,1756049827,247,0,36425
116,1574590247.577805,192.168.1.4,192.168.1.5,1256568322,413630747,79,1,36504
117,1574590247.577927,192.168.1.4,192.168.1.5,1256568401,413630747,79,1,36583
118,1574590247.579664,192.168.1.4,192.168.1.5,1756049827,3391863244,79,1,36662
119,1574590247.580739,192.168.1.4,192.168.1.5,1756049906,3391863244,79,1,36741
120,1574590247.583308,192.168.1.4,192.168.1.5,1549686838,1251732629,2266,1,39007
121,1574590247.583748,192.168.1.4,192.168.1.5,1188124960,476501543,2266,1,41273
122,1574590247.584374,192.168.1.5,192.168.1.4,1251732629,1549689104,74,0,41199
123,1574590247.58451,192.168.1.5,192.168.1.4,1251732703,1549689104,257,0,40942
124,1574590247.585042,192.168.1.4,192.168.1.5,1549689104,1251732960,79,1,41021
125,1574590247.585052,192.168.1.4,192.168.1.5,1549689183,1251732960,79,1,41100
126,1574590247.586044,192.168.1.5,192.168.1.4,476501543,1188127226,74,0,41026
127,1574590247.586208,192.168.1.5,192.168.1.4,476501617,1188127226,257,0,40769
128,1574590247.586576,192.168.1.4,192.168.1.5,1188127226,476501874,79,1,40848
129,1574590247.586685,192.168.1.4,192.168.1.5,1188127305,476501874,79,1,40927
130,1574590247.59135,192.168.1.4,192.168.1.5,872401946,1220607047,2070,1,42997
131,1574590247.5968,192.168.1.4,192.168.1.5,872404016,1220607047,16406,1,59403
132,1574590247.59691,192.168.1.4,192.168.1.5,872420422,1220607047,10136,1,69539
133,1574590247.597137,192.168.1.4,192.168.1.5,872430558,1220607047,14007,1,83546
134,1574590247.610515,192.168.1.5,192.168.1.4,1220607047,872444565,61,0,83485
135,1574590248.601529,192.168.1.5,192.168.1.4,215746603,1193178990,343,0,83142
136,1574590248.602028,192.168.1.4,192.168.1.5,1193178990,215746946,99,1,83241
137,1574590248.602337,192.168.1.5,192.168.1.4,215746946,1193179089,382,0,82859
138,1574590248.612527,192.168.1.4,192.168.1.5,1193179089,215747328,2266,1,85125
139,1574590248.613391,192.168.1.5,192.168.1.4,215747328,1193181355,74,0,85051
140,1574590248.613531,192.168.1.5,192.168.1.4,215747402,1193181355,237,0,84814
141,1574590248.613721,192.168.1.4,192.168.1.5,1193181355,215747639,79,1,84893
142,1574590248.613783,192.168.1.4,192.168.1.5,1193181434,215747639,79,1,84972
143,1574590251.166645,192.168.1.4,192.168.1.5,1756049985,3391863244,91,1,85063
144,1574590251.167126,192.168.1.5,192.168.1.4,3391863244,1756050076,539,0,84524
145,1574590251.211738,192.168.1.4,192.168.1.5,1756050076,3391863783,2070,1,86594
146,1574590251.254406,192.168.1.4,192.168.1.5,1756052146,3391863783,1889,1,88483
147,1574590251.257605,192.168.1.5,192.168.1.4,3391863783,1756054035,86,0,88397
148,1574590251.257917,192.168.1.5,192.168.1.4,3391863869,1756054035,108,0,88289
149,1574590251.258195,192.168.1.5,192.168.1.4,413630747,1256568480,24,0,88265
150,1574590251.260141,192.168.1.5,192.168.1.4,3391863977,1756054035,268,0,87997
151,1574590251.260275,192.168.1.5,192.168.1.4,3391864245,1756054035,138,0,87859
152,1574590251.30081,192.168.1.4,192.168.1.5,1756054035,3391864383,1478,1,89337
153,1574590251.30363,192.168.1.5,192.168.1.4,3391864383,1756055513,53,0,89284
154,1574590251.308041,192.168.1.4,192.168.1.5,1756055513,3391864436,1173,1,90457
155,1574590251.317757,192.168.1.5,192.168.1.4,3391864436,1756056686,61,0,90396
156,1574590251.324736,192.168.1.5,192.168.1.4,1877873421,2719304922,343,0,90053
157,1574590251.325138,192.168.1.4,192.168.1.5,2719304922,1877873764,99,1,90152
158,1574590251.325533,192.168.1.5,192.168.1.4,1877873764,2719305021,382,0,89770
159,1574590251.340489,192.168.1.4,192.168.1.5,2719305021,1877874146,2266,1,92036
160,1574590251.341404,192.168.1.5,192.168.1.4,1877874146,2719307287,74,0,91962
161,1574590251.341621,192.168.1.5,192.168.1.4,1877874220,2719307287,241,0,91721
162,1574590251.34193,192.168.1.4,192.168.1.5,2719307287,1877874461,79,1,91800
163,1574590251.342061,192.168.1.4,192.168.1.5,2719307366,1877874461,79,1,91879
164,1574590251.353146,192.168.1.5,192.168.1.4,1365025084,1355515996,343,0,91536
165,1574590251.353871,192.168.1.4,192.168.1.5,1355515996,1365025427,99,1,91635
166,1574590251.354178,192.168.1.5,192.168.1.4,1365025427,1355516095,382,0,91253
167,1574590251.35635,192.168.1.5,192.168.1.4,1982921735,3556621416,343,0,90910
168,1574590251.359254,192.168.1.5,192.168.1.4,180328514,2407624728,343,0,90567
169,1574590251.360206,192.168.1.4,192.168.1.5,3556621416,1982922078,99,1,90666
170,1574590251.360591,192.168.1.5,192.168.1.4,1982922078,3556621515,382,0,90284
171,1574590251.365511,192.168.1.5,192.168.1.4,3579457521,1672555120,343,0,89941
172,1574590251.366666,192.168.1.4,192.168.1.5,2407624728,180328857,99,1,90040
173,1574590251.367144,192.168.1.5,192.168.1.4,180328857,2407624827,382,0,89658
174,1574590251.374797,192.168.1.4,192.168.1.5,1672555120,3579457864,99,1,89757
175,1574590251.375167,192.168.1.5,192.168.1.4,3579457864,1672555219,382,0,89375
176,1574590251.376427,192.168.1.5,192.168.1.4,1220607108,872444565,117,0,89258
177,1574590251.388817,192.168.1.5,192.168.1.4,1461859552,3046033153,343,0,88915
178,1574590251.390054,192.168.1.5,192.168.1.4,2073494845,1089075787,343,0,88572
179,1574590251.391142,192.168.1.5,192.168.1.4,3950233258,3774253236,343,0,88229
180,1574590251.391683,192.168.1.4,192.168.1.5,3046033153,1461859895,99,1,88328
181,1574590251.392044,192.168.1.5,192.168.1.4,1461859895,3046033252,382,0,87946
182,1574590251.392895,192.168.1.5,192.168.1.4,2435704055,2209947051,343,0,87603
183,1574590251.403808,192.168.1.4,192.168.1.5,1089075787,2073495188,99,1,87702
184,1574590251.404159,192.168.1.5,192.168.1.4,2073495188,1089075886,382,0,87320
185,1574590251.424267,192.168.1.4,192.168.1.5,3774253236,3950233601,99,1,87419
186,1574590251.424692,192.168.1.5,192.168.1.4,3950233601,3774253335,382,0,87037
187,1574590251.426011,192.168.1.4,192.168.1.5,872444565,1220607225,2070,1,89107
188,1574590251.427069,192.168.1.4,192.168.1.5,2209947051,2435704398,99,1,89206
189,1574590251.427434,192.168.1.5,192.168.1.4,2435704398,2209947150,382,0,88824
190,1574590251.439384,192.168.1.4,192.168.1.5,872446635,1220607225,7240,1,96064
191,1574590251.439558,192.168.1.4,192.168.1.5,872453875,1220607225,7240,1,103304
192,1574590251.439604,192.168.1.4,192.168.1.5,872461115,1220607225,1926,1,105230
193,1574590251.439654,192.168.1.4,192.168.1.5,872463041,1220607225,10136,1,115366
194,1574590251.439942,192.168.1.4,192.168.1.5,872473177,1220607225,6270,1,121636
195,1574590251.440283,192.168.1.4,192.168.1.5,872479447,1220607225,756,1,122392
196,1574590251.455247,192.168.1.4,192.168.1.5,1355516095,1365025809,2266,1,124658
197,1574590251.456505,192.168.1.5,192.168.1.4,1365025809,1355518361,74,0,124584
198,1574590251.456757,192.168.1.5,192.168.1.4,1365025883,1355518361,245,0,124339
199,1574590251.45743,192.168.1.4,192.168.1.5,1355518361,1365026128,79,1,124418
200,1574590251.457557,192.168.1.4,192.168.1.5,1355518440,1365026128,79,1,124497
201,1574590251.473849,192.168.1.4,192.168.1.5,3556621515,1982922460,2266,1,126763
202,1574590251.475096,192.168.1.5,192.168.1.4,1982922460,3556623781,74,0,126689
203,1574590251.475313,192.168.1.5,192.168.1.4,1982922534,3556623781,245,0,126444
204,1574590251.479482,192.168.1.4,192.168.1.5,872480203,1220607225,16406,1,142850
205,1574590251.480087,192.168.1.4,192.168.1.5,872496609,1220607225,16406,1,159256
206,1574590251.48016,192.168.1.4,192.168.1.5,872513015,1220607225,1286,1,160542
207,1574590251.480169,192.168.1.4,192.168.1.5,3556623781,1982922779,79,1,160621
208,1574590251.483816,192.168.1.4,192.168.1.5,3556623860,1982922779,79,1,160700
209,1574590251.483841,192.168.1.4,192.168.1.5,2407624827,180329239,2266,1,162966
210,1574590251.485134,192.168.1.5,192.168.1.4,180329239,2407627093,74,0,162892
211,1574590251.485494,192.168.1.5,192.168.1.4,180329313,2407627093,245,0,162647
212,1574590251.486348,192.168.1.4,192.168.1.5,2407627093,180329558,79,1,162726
213,1574590251.486482,192.168.1.4,192.168.1.5,2407627172,180329558,79,1,162805
214,1574590251.493724,192.168.1.4,192.168.1.5,3774253335,3950233983,2266,1,165071
215,1574590251.495192,192.168.1.5,192.168.1.4,3950233983,3774255601,74,0,164997
216,1574590251.49545,192.168.1.5,192.168.1.4,3950234057,3774255601,257,0,164740
217,1574590251.501184,192.168.1.4,192.168.1.5,1089075886,2073495570,2266,1,167006
218,1574590251.502557,192.168.1.5,192.168.1.4,2073495570,1089078152,74,0,166932
219,1574590251.502759,192.168.1.5,192.168.1.4,2073495644,1089078152,257,0,166675
220,1574590251.503115,192.168.1.4,192.168.1.5,1672555219,3579458246,2266,1,168941
221,1574590251.504396,192.168.1.5,192.168.1.4,3579458246,1672557485,74,0,168867
222,1574590251.504586,192.168.1.5,192.168.1.4,3579458320,1672557485,237,0,168630
223,1574590251.505417,192.168.1.4,192.168.1.5,3046033252,1461860277,2266,1,170896
224,1574590251.505584,192.168.1.4,192.168.1.5,1672557485,3579458557,79,1,170975
225,1574590251.505697,192.168.1.4,192.168.1.5,1672557564,3579458557,79,1,171054
226,1574590251.506857,192.168.1.4,192.168.1.5,1089078152,2073495901,79,1,171133
227,1574590251.506939,192.168.1.4,192.168.1.5,1089078231,2073495901,79,1,171212
228,1574590251.507346,192.168.1.4,192.168.1.5,3774255601,3950234314,79,1,171291
229,1574590251.50743,192.168.1.4,192.168.1.5,3774255680,3950234314,79,1,171370
230,1574590251.507917,192.168.1.5,192.168.1.4,1461860277,3046035518,74,0,171296
231,1574590251.508148,192.168.1.5,192.168.1.4,1461860351,3046035518,257,0,171039
232,1574590251.508398,192.168.1.4,192.168.1.5,3046035518,1461860608,79,1,171118
233,1574590251.508514,192.168.1.4,192.168.1.5,3046035597,1461860608,79,1,171197
234,1574590251.510297,192.168.1.4,192.168.1.5,2209947150,2435704780,2266,1,173463
235,1574590251.518031,192.168.1.4,192.168.1.5,1672557564,3579458557,79,1,173542
236,1574590251.521014,192.168.1.5,192.168.1.4,2435704780,2209949416,74,0,173468
237,1574590251.521282,192.168.1.5,192.168.1.4,2435704854,2209949416,257,0,173211
238,1574590251.521492,192.168.1.4,192.168.1.5,2209949416,2435705111,79,1,173290
239,1574590251.521609,192.168.1.4,192.168.1.5,2209949495,2435705111,79,1,173369
240,1574590251.522265,192.168.1.4,192.168.1.5,872514301,1220607225,5792,1,179161
241,1574590251.522447,192.168.1.4,192.168.1.5,872520093,1220607225,10614,1,189775
242,1574590251.522489,192.168.1.4,192.168.1.5,872530707,1220607225,6156,1,195931
243,1574590251.523718,192.168.1.5,192.168.1.4,1220607225,872536863,61,0,195870
244,1574590251.629619,192.168.1.5,192.168.1.4,1542120278,3367659038,343,0,195527
245,1574590251.630299,192.168.1.4,192.168.1.5,3367659038,1542120621,99,1,195626
246,1574590251.630545,192.168.1.5,192.168.1.4,1542120621,3367659137,382,0,195244
247,1574590251.640975,192.168.1.4,192.168.1.5,3367659137,1542121003,2266,1,197510
248,1574590251.641838,192.168.1.5,192.168.1.4,1542121003,3367661403,74,0,197436
249,1574590251.641957,192.168.1.5,192.168.1.4,1542121077,3367661403,255,0,197181
250,1574590251.642269,192.168.1.4,192.168.1.5,3367661403,1542121332,79,1,197260
251,1574590251.6471,192.168.1.4,192.168.1.5,3367661482,1542121332,79,1,197339
252,1574590251.834781,192.168.1.5,192.168.1.4,2851384045,3048190689,343,0,196996
253,1574590251.835325,192.168.1.4,192.168.1.5,3048190689,2851384388,99,1,197095
254,1574590251.835622,192.168.1.5,192.168.1.4,2851384388,3048190788,382,0,196713
255,1574590251.840615,192.168.1.5,192.168.1.4,3000686092,3432639326,343,0,196370
256,1574590251.846115,192.168.1.4,192.168.1.5,3048190788,2851384770,2266,1,198636
257,1574590251.84667,192.168.1.4,192.168.1.5,3432639326,3000686435,99,1,198735
258,1574590251.847279,192.168.1.5,192.168.1.4,2851384770,3048193054,74,0,198661
259,1574590251.847386,192.168.1.5,192.168.1.4,2851384844,3048193054,241,0,198420
260,1574590251.847582,192.168.1.4,192.168.1.5,3048193054,2851385085,79,1,198499
261,1574590251.847645,192.168.1.4,192.168.1.5,3048193133,2851385085,79,1,198578
262,1574590251.847689,192.168.1.5,192.168.1.4,3000686435,3432639425,382,0,198196
263,1574590251.848801,192.168.1.5,192.168.1.4,2749292850,3813083489,343,0,197853
264,1574590251.850672,192.168.1.5,192.168.1.4,3904630755,4088903750,343,0,197510
265,1574590251.85205,192.168.1.4,192.168.1.5,1549689262,1251732960,91,1,197601
266,1574590251.85216,192.168.1.4,192.168.1.5,1256568480,413630771,91,1,197692
267,1574590251.852169,192.168.1.4,192.168.1.5,1256568571,413630771,24,1,197716
268,1574590251.854298,192.168.1.5,192.168.1.4,4241977959,3004443543,343,0,197373
269,1574590251.854649,192.168.1.5,192.168.1.4,1251732960,1549689353,539,0,196834
270,1574590251.858275,192.168.1.4,192.168.1.5,4088903750,3904631098,99,1,196933
271,1574590251.858571,192.168.1.5,192.168.1.4,3904631098,4088903849,382,0,196551
272,1574590251.858865,192.168.1.4,192.168.1.5,3813083489,2749293193,99,1,196650
273,1574590251.859084,192.168.1.5,192.168.1.4,2749293193,3813083588,382,0,196268
274,1574590251.867137,192.168.1.4,192.168.1.5,3004443543,4241978302,99,1,196367
275,1574590251.867477,192.168.1.5,192.168.1.4,4241978302,3004443642,382,0,195985
276,1574590251.874122,192.168.1.4,192.168.1.5,3432639425,3000686817,2266,1,198251
277,1574590251.874997,192.168.1.5,192.168.1.4,3000686817,3432641691,74,0,198177
278,1574590251.875133,192.168.1.5,192.168.1.4,3000686891,3432641691,241,0,197936
279,1574590251.886737,192.168.1.4,192.168.1.5,3432641691,3000687132,79,1,198015
280,1574590251.886767,192.168.1.4,192.168.1.5,3432641770,3000687132,79,1,198094
281,1574590251.89001,192.168.1.4,192.168.1.5,4088903849,3904631480,2266,1,200360
282,1574590251.890863,192.168.1.5,192.168.1.4,3904631480,4088906115,74,0,200286
283,1574590251.890973,192.168.1.5,192.168.1.4,3904631554,4088906115,241,0,200045
284,1574590251.892197,192.168.1.4,192.168.1.5,3004443642,4241978684,2266,1,202311
285,1574590251.892955,192.168.1.4,192.168.1.5,3813083588,2749293575,2266,1,204577
286,1574590251.893703,192.168.1.5,192.168.1.4,2749293575,3813085854,74,0,204503
287,1574590251.893818,192.168.1.4,192.168.1.5,4088906115,3904631795,79,1,204582
288,1574590251.893832,192.168.1.4,192.168.1.5,4088906194,3904631795,79,1,204661
289,1574590251.89387,192.168.1.5,192.168.1.4,2749293649,3813085854,241,0,204420
290,1574590251.894117,192.168.1.4,192.168.1.5,3813085854,2749293890,79,1,204499
291,1574590251.894183,192.168.1.4,192.168.1.5,3813085933,2749293890,79,1,204578
292,1574590251.894572,192.168.1.5,192.168.1.4,4241978684,3004445908,74,0,204504
293,1574590251.894688,192.168.1.5,192.168.1.4,4241978758,3004445908,241,0,204263
294,1574590251.894953,192.168.1.4,192.168.1.5,3004445908,4241978999,79,1,204342
295,1574590251.896155,192.168.1.4,192.168.1.5,3004445987,4241978999,79,1,204421
296,1574590251.905615,192.168.1.4,192.168.1.5,1549689353,1251733499,2070,1,206491
297,1574590251.94623,192.168.1.4,192.168.1.5,1549691423,1251733499,2724,1,209215
298,1574590251.949708,192.168.1.5,192.168.1.4,1251733499,1549694147,86,0,209129
299,1574590251.950254,192.168.1.5,192.168.1.4,1251733585,1549694147,108,0,209021
300,1574590251.950502,192.168.1.5,192.168.1.4,476501874,1188127384,24,0,208997
301,1574590251.950654,192.168.1.5,192.168.1.4,1461860608,3046035676,24,0,208973
302,1574590251.9508,192.168.1.5,192.168.1.4,2073495901,1089078310,24,0,208949
303,1574590251.95092,192.168.1.5,192.168.1.4,3950234314,3774255759,24,0,208925
304,1574590251.95104,192.168.1.5,192.168.1.4,2435705111,2209949574,24,0,208901
305,1574590251.953208,192.168.1.5,192.168.1.4,1251733693,1549694147,351,0,208550
306,1574590251.957567,192.168.1.5,192.168.1.4,1251734044,1549694147,161,0,208389
307,1574590251.957749,192.168.1.5,192.168.1.4,1251734205,1549694147,158,0,208231
308,1574590251.957939,192.168.1.5,192.168.1.4,1251734363,1549694147,158,0,208073
309,1574590251.958038,192.168.1.5,192.168.1.4,1251734521,1549694147,160,0,207913
310,1574590251.958232,192.168.1.5,192.168.1.4,1251734681,1549694147,159,0,207754
311,1574590251.984051,192.168.1.4,192.168.1.5,1549694147,1251734840,617,1,208371
312,1574590251.984519,192.168.1.5,192.168.1.4,1251734840,1549694764,53,0,208318
313,1574590251.988557,192.168.1.4,192.168.1.5,1549694764,1251734893,2070,1,210388
314,1574590252.025383,192.168.1.4,192.168.1.5,1549696834,1251734893,14480,1,224868
315,1574590252.025852,192.168.1.4,192.168.1.5,1549711314,1251734893,17376,1,242244
316,1574590252.025978,192.168.1.4,192.168.1.5,1549728690,1251734893,1740,1,243984
317,1574590252.028329,192.168.1.5,192.168.1.4,1251734893,1549730430,61,0,243923
318,1574590252.029078,192.168.1.4,192.168.1.5,1549730430,1251734954,7112,1,251035
319,1574590252.029673,192.168.1.5,192.168.1.4,3454523450,438015137,343,0,250692
320,1574590252.0302,192.168.1.4,192.168.1.5,438015137,3454523793,99,1,250791
321,1574590252.030445,192.168.1.5,192.168.1.4,3454523793,438015236,382,0,250409
322,1574590252.043163,192.168.1.4,192.168.1.5,438015236,3454524175,2266,1,252675
323,1574590252.044215,192.168.1.5,192.168.1.4,3454524175,438017502,74,0,252601
324,1574590252.044495,192.168.1.4,192.168.1.5,438017502,3454524249,79,1,252680
325,1574590252.044513,192.168.1.4,192.168.1.5,438017581,3454524249,79,1,252759
326,1574590252.047502,192.168.1.5,192.168.1.4,3454524249,438017660,265,0,252494
327,1574590252.04972,192.168.1.4,192.168.1.5,1549737542,1251734954,16406,1,268900
328,1574590252.049783,192.168.1.4,192.168.1.5,1549753948,1251734954,16406,1,285306
329,1574590252.049818,192.168.1.4,192.168.1.5,1549770354,1251734954,1286,1,286592
330,1574590252.065646,192.168.1.4,192.168.1.5,1549771640,1251734954,16406,1,302998
331,1574590252.065752,192.168.1.4,192.168.1.5,1549788046,1251734954,16406,1,319404
332,1574590252.065919,192.168.1.4,192.168.1.5,1549804452,1251734954,1914,1,321318
333,1574590252.076109,192.168.1.4,192.168.1.5,1549806366,1251734954,16406,1,337724
334,1574590252.076206,192.168.1.4,192.168.1.5,1549822772,1251734954,16406,1,354130
335,1574590252.076234,192.168.1.4,192.168.1.5,1549839178,1251734954,658,1,354788
336,1574590252.087553,192.168.1.4,192.168.1.5,1549839836,1251734954,16406,1,371194
337,1574590252.087638,192.168.1.4,192.168.1.5,1549856242,1251734954,16406,1,387600
338,1574590252.089012,192.168.1.4,192.168.1.5,1549872648,1251734954,1916,1,389516
339,1574590252.090358,192.168.1.5,192.168.1.4,3563844668,2202828514,343,0,389173
340,1574590252.090741,192.168.1.4,192.168.1.5,2202828514,3563845011,99,1,389272
341,1574590252.091009,192.168.1.5,192.168.1.4,3563845011,2202828613,382,0,388890
342,1574590252.09299,192.168.1.5,192.168.1.4,1027463386,646271797,343,0,388547
343,1574590252.100621,192.168.1.4,192.168.1.5,2202828613,3563845393,2266,1,390813
344,1574590252.101192,192.168.1.4,192.168.1.5,646271797,1027463729,99,1,390912
345,1574590252.101866,192.168.1.5,192.168.1.4,3563845393,2202830879,74,0,390838
346,1574590252.101989,192.168.1.5,192.168.1.4,3563845467,2202830879,265,0,390573
347,1574590252.102181,192.168.1.4,192.168.1.5,2202830879,3563845732,79,1,390652
348,1574590252.102356,192.168.1.5,192.168.1.4,1027463729,646271896,382,0,390270
349,1574590252.102406,192.168.1.4,192.168.1.5,2202830958,3563845732,79,1,390349
350,1574590252.11276,192.168.1.4,192.168.1.5,646271896,1027464111,2266,1,392615
351,1574590252.114305,192.168.1.5,192.168.1.4,1027464111,646274162,74,0,392541
352,1574590252.11452,192.168.1.5,192.168.1.4,1027464185,646274162,265,0,392276
353,1574590252.114829,192.168.1.4,192.168.1.5,646274162,1027464450,79,1,392355
354,1574590252.116232,192.168.1.4,192.168.1.5,646274241,1027464450,79,1,392434
355,1574590252.118871,192.168.1.5,192.168.1.4,3422984725,590263383,343,0,392091
356,1574590252.119296,192.168.1.4,192.168.1.5,590263383,3422985068,99,1,392190
357,1574590252.119581,192.168.1.5,192.168.1.4,3422985068,590263482,382,0,391808
358,1574590252.124355,192.168.1.5,192.168.1.4,1257367367,3747524036,343,0,391465
359,1574590252.129771,192.168.1.4,192.168.1.5,590263482,3422985450,2266,1,393731
360,1574590252.130321,192.168.1.4,192.168.1.5,1549874564,1251734954,4939,1,398670
361,1574590252.13054,192.168.1.4,192.168.1.5,3747524036,1257367710,99,1,398769
362,1574590252.131095,192.168.1.5,192.168.1.4,3422985450,590265748,74,0,398695
363,1574590252.131241,192.168.1.5,192.168.1.4,3422985524,590265748,265,0,398430
364,1574590252.131402,192.168.1.4,192.168.1.5,590265748,3422985789,79,1,398509
365,1574590252.131471,192.168.1.4,192.168.1.5,590265827,3422985789,79,1,398588
366,1574590252.131822,192.168.1.5,192.168.1.4,1257367710,3747524135,382,0,398206
367,1574590252.136344,192.168.1.5,192.168.1.4,3193850033,1607853988,343,0,397863
368,1574590252.138683,192.168.1.4,192.168.1.5,1607853988,3193850376,99,1,397962
369,1574590252.139055,192.168.1.5,192.168.1.4,3193850376,1607854087,382,0,397580
370,1574590252.145863,192.168.1.4,192.168.1.5,3747524135,1257368092,2266,1,399846
371,1574590252.146898,192.168.1.5,192.168.1.4,1257368092,3747526401,74,0,399772
372,1574590252.147023,192.168.1.5,192.168.1.4,1257368166,3747526401,265,0,399507
373,1574590252.150215,192.168.1.4,192.168.1.5,3747526401,1257368431,79,1,399586
374,1574590252.150246,192.168.1.4,192.168.1.5,3747526480,1257368431,79,1,399665
375,1574590252.153418,192.168.1.4,192.168.1.5,1607854087,3193850758,2266,1,401931
376,1574590252.155034,192.168.1.5,192.168.1.4,3193850758,1607856353,74,0,401857
377,1574590252.155242,192.168.1.5,192.168.1.4,3193850832,1607856353,265,0,401592
378,1574590252.155575,192.168.1.4,192.168.1.5,1607856353,3193851097,79,1,401671
379,1574590252.155861,192.168.1.4,192.168.1.5,1607856432,3193851097,79,1,401750
380,1574590252.509768,192.168.1.4,192.168.1.5,1188127384,476501898,91,1,401841
381,1574590252.509794,192.168.1.4,192.168.1.5,1188127475,476501898,24,1,401865
382,1574590253.635999,192.168.1.4,192.168.1.5,1193181513,215747639,91,1,401956
383,1574590253.637134,192.168.1.5,192.168.1.4,215747639,1193181604,539,0,401417
384,1574590253.678584,192.168.1.4,192.168.1.5,1193181604,215748178,2070,1,403487
385,1574590253.722588,192.168.1.4,192.168.1.5,1193183674,215748178,1757,1,405244
386,1574590253.730255,192.168.1.5,192.168.1.4,215748178,1193185431,86,0,405158
387,1574590253.731005,192.168.1.5,192.168.1.4,215748264,1193185431,108,0,405050
388,1574590253.731595,192.168.1.5,192.168.1.4,215748372,1193185431,279,0,404771
389,1574590253.763506,192.168.1.4,192.168.1.5,1193185431,215748651,617,1,405388
390,1574590253.764098,192.168.1.5,192.168.1.4,215748651,1193186048,53,0,405335
391,1574590253.770274,192.168.1.4,192.168.1.5,1193186048,215748704,2070,1,407405
392,1574590253.810177,192.168.1.4,192.168.1.5,1193188118,215748704,832,1,408237
393,1574590253.81074,192.168.1.5,192.168.1.4,215748704,1193188950,61,0,408176
394,1574590256.978293,192.168.1.4,192.168.1.5,2407627251,180329558,91,1,408267
395,1574590256.978475,192.168.1.4,192.168.1.5,1355518519,1365026128,91,1,408358
396,1574590256.978915,192.168.1.4,192.168.1.5,2719307445,1877874461,91,1,408449
397,1574590256.98174,192.168.1.5,192.168.1.4,180329558,2407627342,539,0,407910
398,1574590256.982254,192.168.1.5,192.168.1.4,1365026128,1355518610,539,0,407371
399,1574590256.982558,192.168.1.5,192.168.1.4,1877874461,2719307536,539,0,406832
400,1574590257.021608,192.168.1.4,192.168.1.5,2407627342,180330097,2070,1,408902
401,1574590257.03605,192.168.1.4,192.168.1.5,1355518610,1365026667,2070,1,410972
402,1574590257.036273,192.168.1.4,192.168.1.5,2719307536,1877875000,2070,1,413042
403,1574590257.062252,192.168.1.4,192.168.1.5,2407629412,180330097,1889,1,414931
404,1574590257.065831,192.168.1.5,192.168.1.4,180330097,2407631301,86,0,414845
405,1574590257.066225,192.168.1.5,192.168.1.4,180330183,2407631301,108,0,414737
406,1574590257.066443,192.168.1.5,192.168.1.4,1365026667,1355520680,24,0,414713
407,1574590257.066671,192.168.1.5,192.168.1.4,1982922779,3556623939,24,0,414689
408,1574590257.067694,192.168.1.4,192.168.1.5,1355520680,1365026691,1888,1,416577
409,1574590257.067917,192.168.1.4,192.168.1.5,1355522568,1365026691,24,1,416601
410,1574590257.070068,192.168.1.5,192.168.1.4,180330291,2407631301,266,0,416335
411,1574590257.070316,192.168.1.5,192.168.1.4,180330557,2407631301,110,0,416225
412,1574590257.070523,192.168.1.5,192.168.1.4,180330667,2407631301,108,0,416117
413,1574590257.08219,192.168.1.4,192.168.1.5,2719309606,1877875000,1757,1,417874
414,1574590257.086094,192.168.1.5,192.168.1.4,1877875000,2719311363,86,0,417788
415,1574590257.086575,192.168.1.5,192.168.1.4,1877875086,2719311363,108,0,417680
416,1574590257.086965,192.168.1.5,192.168.1.4,2851385085,3048193212,24,0,417656
417,1574590257.087154,192.168.1.5,192.168.1.4,3000687132,3432641849,24,0,417632
418,1574590257.087358,192.168.1.5,192.168.1.4,2749293890,3813086012,24,0,417608
419,1574590257.087527,192.168.1.5,192.168.1.4,3904631795,4088906273,24,0,417584
420,1574590257.087704,192.168.1.5,192.168.1.4,4241978999,3004446066,24,0,417560
421,1574590257.094229,192.168.1.5,192.168.1.4,1877875194,2719311363,381,0,417179
422,1574590257.095131,192.168.1.5,192.168.1.4,1877875575,2719311363,110,0,417069
423,1574590257.095379,192.168.1.5,192.168.1.4,1877875685,2719311363,118,0,416951
424,1574590257.096214,192.168.1.5,192.168.1.4,1877875803,2719311363,115,0,416836
425,1574590257.096648,192.168.1.5,192.168.1.4,1877875918,2719311363,109,0,416727
426,1574590257.096951,192.168.1.5,192.168.1.4,1877876027,2719311363,107,0,416620
427,1574590257.097198,192.168.1.5,192.168.1.4,1877876134,2719311363,158,0,416462
428,1574590257.097476,192.168.1.5,192.168.1.4,1877876292,2719311363,109,0,416353
429,1574590257.097643,192.168.1.5,192.168.1.4,1877876401,2719311363,109,0,416244
430,1574590257.102238,192.168.1.4,192.168.1.5,2407631301,180330775,617,1,416861
431,1574590257.102507,192.168.1.5,192.168.1.4,180330775,2407631918,53,0,416808
432,1574590257.107136,192.168.1.4,192.168.1.5,2407631918,180330828,2070,1,418878
433,1574590257.120288,192.168.1.4,192.168.1.5,2719311363,1877876510,617,1,419495
434,1574590257.120737,192.168.1.5,192.168.1.4,1877876510,2719311980,53,0,419442
435,1574590257.143711,192.168.1.4,192.168.1.5,2719311980,1877876563,2070,1,421512
436,1574590257.145662,192.168.1.4,192.168.1.5,2407633988,180330828,14480,1,435992
437,1574590257.146243,192.168.1.4,192.168.1.5,2407648468,180330828,19904,1,455896
438,1574590257.167261,192.168.1.4,192.168.1.5,2407668372,180330828,16406,1,472302
439,1574590257.16758,192.168.1.4,192.168.1.5,2407684778,180330828,16406,1,488708
440,1574590257.167623,192.168.1.4,192.168.1.5,2407701184,180330828,656,1,489364
441,1574590257.16913,192.168.1.5,192.168.1.4,180330828,2407701840,61,0,489303
442,1574590257.169506,192.168.1.4,192.168.1.5,2407701840,180330889,810,1,490113
443,1574590257.176096,192.168.1.4,192.168.1.5,2719314050,1877876563,7240,1,497353
444,1574590257.176315,192.168.1.4,192.168.1.5,2719321290,1877876563,7240,1,504593
445,1574590257.176496,192.168.1.4,192.168.1.5,2719328530,1877876563,19357,1,523950
446,1574590257.19153,192.168.1.5,192.168.1.4,1877876563,2719347887,61,0,523889
447,1574590257.191961,192.168.1.4,192.168.1.5,2719347887,1877876624,16406,1,540295
448,1574590257.19206,192.168.1.4,192.168.1.5,2719364293,1877876624,7744,1,548039
449,1574590257.210295,192.168.1.4,192.168.1.5,2407702650,180330889,1806,1,549845
450,1574590257.211759,192.168.1.4,192.168.1.5,2719372037,1877876624,14480,1,564325
451,1574590257.212016,192.168.1.4,192.168.1.5,2719386517,1877876624,1926,1,566251
452,1574590257.212057,192.168.1.4,192.168.1.5,2719388443,1877876624,16406,1,582657
453,1574590257.212087,192.168.1.4,192.168.1.5,2719404849,1877876624,498,1,583155
454,1574590257.222239,192.168.1.4,192.168.1.5,2719405347,1877876624,16406,1,599561
455,1574590257.222339,192.168.1.4,192.168.1.5,2719421753,1877876624,16406,1,615967
456,1574590257.223165,192.168.1.4,192.168.1.5,2719438159,1877876624,1286,1,617253
457,1574590257.229057,192.168.1.4,192.168.1.5,2209949574,2435705135,91,1,617344
458,1574590257.229245,192.168.1.4,192.168.1.5,2209949665,2435705135,24,1,617368
459,1574590257.240492,192.168.1.4,192.168.1.5,2719439445,1877876624,16406,1,633774
460,1574590257.24088,192.168.1.4,192.168.1.5,2719455851,1877876624,14480,1,648254
461,1574590257.241083,192.168.1.4,192.168.1.5,2719470331,1877876624,1926,1,650180
462,1574590257.241111,192.168.1.4,192.168.1.5,2719472257,1877876624,656,1,650836
463,1574590257.24125,192.168.1.4,192.168.1.5,2719472913,1877876624,2070,1,652906
464,1574590257.241387,192.168.1.4,192.168.1.5,2719474983,1877876624,2070,1,654976
465,1574590257.283623,192.168.1.4,192.168.1.5,2719477053,1877876624,16406,1,671382
466,1574590257.283733,192.168.1.4,192.168.1.5,2719493459,1877876624,16406,1,687788
467,1574590257.283768,192.168.1.4,192.168.1.5,2719509865,1877876624,5524,1,693312
468,1574590257.382525,192.168.1.5,192.168.1.4,1877876624,2719515389,109,0,693203
469,1574590257.385003,192.168.1.4,192.168.1.5,1089078310,2073495925,91,1,693294
470,1574590257.385178,192.168.1.4,192.168.1.5,4088906273,3904631819,91,1,693385
471,1574590257.385282,192.168.1.4,192.168.1.5,3046035676,1461860632,91,1,693476
472,1574590257.385387,192.168.1.4,192.168.1.5,3556623939,1982922803,91,1,693567
473,1574590257.385546,192.168.1.4,192.168.1.5,3432641849,3000687156,91,1,693658
474,1574590257.385643,192.168.1.4,192.168.1.5,1672557643,3579458557,91,1,693749
475,1574590257.385804,192.168.1.4,192.168.1.5,3774255759,3950234338,91,1,693840
476,1574590257.386292,192.168.1.4,192.168.1.5,3774255850,3950234338,24,1,693864
477,1574590257.387076,192.168.1.4,192.168.1.5,3046035767,1461860633,24,1,693888
478,1574590257.387621,192.168.1.4,192.168.1.5,4088906364,3904631820,24,1,693912
479,1574590257.388341,192.168.1.4,192.168.1.5,3432641940,3000687157,24,1,693936
480,1574590257.388663,192.168.1.4,192.168.1.5,3556624030,1982922804,24,1,693960
481,1574590257.389787,192.168.1.5,192.168.1.4,3579458557,1672557734,539,0,693421
482,1574590257.390201,192.168.1.4,192.168.1.5,1089078401,2073495926,24,1,693445
483,1574590257.426996,192.168.1.4,192.168.1.5,2719515389,1877876733,5755,1,699200
484,1574590257.428216,192.168.1.5,192.168.1.4,1877876733,2719521144,61,0,699139
485,1574590257.433556,192.168.1.4,192.168.1.5,1672557734,3579459096,2070,1,701209
486,1574590257.474332,192.168.1.4,192.168.1.5,1672559804,3579459096,1755,1,702964
487,1574590257.479992,192.168.1.5,192.168.1.4,3579459096,1672561559,86,0,702878
488,1574590257.481407,192.168.1.5,192.168.1.4,3579459182,1672561559,108,0,702770
489,1574590257.483739,192.168.1.5,192.168.1.4,3579459290,1672561559,266,0,702504
490,1574590257.51485,192.168.1.4,192.168.1.5,1672561559,3579459556,617,1,703121
491,1574590257.515216,192.168.1.5,192.168.1.4,3579459556,1672562176,53,0,703068
492,1574590257.518569,192.168.1.4,192.168.1.5,3367661561,1542121332,91,1,703159
493,1574590257.519164,192.168.1.5,192.168.1.4,1542121332,3367661652,539,0,702620
494,1574590257.52207,192.168.1.4,192.168.1.5,1672562176,3579459609,381,1,703001
495,1574590257.562426,192.168.1.4,192.168.1.5,1672562557,3579459609,6092,1,709093
496,1574590257.565407,192.168.1.4,192.168.1.5,3367661652,1542121871,2070,1,711163
497,1574590257.569953,192.168.1.5,192.168.1.4,3579459609,1672568649,61,0,711102
498,1574590257.606325,192.168.1.4,192.168.1.5,3367663722,1542121871,1249,1,712351
499,1574590257.611476,192.168.1.5,192.168.1.4,1542121871,3367664971,86,0,712265
500,1574590257.612828,192.168.1.5,192.168.1.4,1542121957,3367664971,108,0,712157
501,1574590257.613925,192.168.1.5,192.168.1.4,1542122065,3367664971,259,0,711898
502,1574590257.655595,192.168.1.4,192.168.1.5,3367664971,1542122324,617,1,712515
503,1574590257.656102,192.168.1.5,192.168.1.4,1542122324,3367665588,53,0,712462
504,1574590257.656395,192.168.1.4,192.168.1.5,3367665588,1542122377,3298,1,715760
