index,time,src_ip,dst_ip,tcp_seq,tcp_ack,tcp_len,direction,cumul_sum
1,1574590650.401892,192.168.1.4,192.168.1.5,3178963830,1609699044,91,1,91
2,1574590650.401916,192.168.1.4,192.168.1.5,3178963921,1609699044,24,1,115
3,1574590650.655894,192.168.1.4,192.168.1.5,1009814647,3514046436,91,1,206
4,1574590650.655924,192.168.1.4,192.168.1.5,1009814738,3514046436,24,1,230
5,1574590650.656398,192.168.1.4,192.168.1.5,2565895552,3078615603,91,1,321
6,1574590650.65658,192.168.1.4,192.168.1.5,2565895643,3078615603,24,1,345
7,1574590651.592013,192.168.1.4,192.168.1.5,280100068,3186385111,91,1,436
8,1574590651.59212,192.168.1.4,192.168.1.5,280100159,3186385111,24,1,460
9,1574590651.704776,192.168.1.4,192.168.1.5,3383332463,4132121092,91,1,551
10,1574590651.704798,192.168.1.4,192.168.1.5,3383332554,4132121092,24,1,575
11,1574590655.37231,192.168.1.5,192.168.1.4,2285428428,1842737870,343,0,232
12,1574590655.37296,192.168.1.4,192.168.1.5,1842737870,2285428771,99,1,331
13,1574590655.373613,192.168.1.5,192.168.1.4,2285428771,1842737969,382,0,-51
14,1574590655.387393,192.168.1.4,192.168.1.5,1842737969,2285429153,2266,1,2215
15,1574590655.388301,192.168.1.5,192.168.1.4,2285429153,1842740235,74,0,2141
16,1574590655.388435,192.168.1.5,192.168.1.4,2285429227,1842740235,245,0,1896
17,1574590655.388723,192.168.1.4,192.168.1.5,1842740235,2285429472,79,1,1975
18,1574590655.3888,192.168.1.4,192.168.1.5,1842740314,2285429472,79,1,2054
19,1574590655.533673,192.168.1.5,192.168.1.4,2343548704,2292287616,343,0,1711
20,1574590655.53405,192.168.1.4,192.168.1.5,2292287616,2343549047,99,1,1810
21,1574590655.53434,192.168.1.5,192.168.1.4,2343549047,2292287715,382,0,1428
22,1574590655.536264,192.168.1.5,192.168.1.4,3870454184,2701671912,343,0,1085
23,1574590655.54422,192.168.1.4,192.168.1.5,2292287715,2343549429,2266,1,3351
24,1574590655.544877,192.168.1.4,192.168.1.5,2701671912,3870454527,99,1,3450
25,1574590655.545203,192.168.1.5,192.168.1.4,2343549429,2292289981,74,0,3376
26,1574590655.545523,192.168.1.4,192.168.1.5,2292289981,2343549503,79,1,3455
27,1574590655.545539,192.168.1.5,192.168.1.4,2343549503,2292290060,235,0,3220
28,1574590655.545562,192.168.1.4,192.168.1.5,2292290060,2343549503,79,1,3299
29,1574590655.545933,192.168.1.5,192.168.1.4,3870454527,2701672011,382,0,2917
30,1574590655.556448,192.168.1.4,192.168.1.5,2701672011,3870454909,2266,1,5183
31,1574590655.557363,192.168.1.5,192.168.1.4,3870454909,2701674277,74,0,5109
32,1574590655.557484,192.168.1.5,192.168.1.4,3870454983,2701674277,235,0,4874
33,1574590655.557894,192.168.1.4,192.168.1.5,2701674277,3870454983,79,1,4953
34,1574590655.558037,192.168.1.4,192.168.1.5,2701674356,3870455218,79,1,5032
35,1574590658.140494,192.168.1.4,192.168.1.5,1842740393,2285429472,91,1,5123
36,1574590658.141602,192.168.1.5,192.168.1.4,2285429472,1842740484,539,0,4584
37,1574590658.192844,192.168.1.4,192.168.1.5,1842740484,2285430011,2070,1,6654
38,1574590658.234484,192.168.1.4,192.168.1.5,1842742554,2285430011,1018,1,7672
39,1574590658.246502,192.168.1.5,192.168.1.4,2285430011,1842743572,86,0,7586
40,1574590658.25186,192.168.1.5,192.168.1.4,2285430097,1842743572,108,0,7478
41,1574590658.2525,192.168.1.5,192.168.1.4,2285430205,1842743572,321,0,7157
42,1574590658.252785,192.168.1.5,192.168.1.4,2285430526,1842743572,54,0,7103
43,1574590658.279325,192.168.1.4,192.168.1.5,1842743572,2285430580,586,1,7689
44,1574590658.279871,192.168.1.5,192.168.1.4,2285430580,1842744158,53,0,7636
45,1574590658.284729,192.168.1.4,192.168.1.5,1842744158,2285430633,53,1,7689
46,1574590658.329247,192.168.1.4,192.168.1.5,1842744211,2285430633,1327,1,9016
47,1574590658.333584,192.168.1.5,192.168.1.4,2285430633,1842745538,61,0,8955
48,1574590658.372391,192.168.1.4,192.168.1.5,2292290139,2343549738,91,1,9046
49,1574590658.373302,192.168.1.5,192.168.1.4,2343549738,2292290230,539,0,8507
50,1574590658.426871,192.168.1.4,192.168.1.5,2292290230,2343550277,2070,1,10577
51,1574590658.470381,192.168.1.4,192.168.1.5,2292292300,2343550277,599,1,11176
52,1574590658.473714,192.168.1.5,192.168.1.4,2343550277,2292292899,86,0,11090
53,1574590658.474232,192.168.1.5,192.168.1.4,2343550363,2292292899,108,0,10982
54,1574590658.474942,192.168.1.5,192.168.1.4,2343550471,2292292899,381,0,10601
55,1574590658.506861,192.168.1.4,192.168.1.5,2292292899,2343550852,617,1,11218
56,1574590658.50728,192.168.1.5,192.168.1.4,2343550852,2292293516,53,0,11165
57,1574590658.516476,192.168.1.4,192.168.1.5,2292293516,2343550905,570,1,11735
58,1574590658.558358,192.168.1.4,192.168.1.5,2292294086,2343550905,11584,1,23319
59,1574590658.558479,192.168.1.4,192.168.1.5,2292305670,2343550905,4192,1,27511
60,1574590658.559822,192.168.1.5,192.168.1.4,2343550905,2292309862,61,0,27450
61,1574590658.575488,192.168.1.5,192.168.1.4,2451414074,2692663168,343,0,27107
62,1574590658.575853,192.168.1.4,192.168.1.5,2692663168,2451414417,99,1,27206
63,1574590658.576198,192.168.1.5,192.168.1.4,2451414417,2692663267,382,0,26824
64,1574590658.578927,192.168.1.5,192.168.1.4,76883262,3557299688,343,0,26481
65,1574590658.58113,192.168.1.5,192.168.1.4,2343550966,2292309862,149,0,26332
66,1574590658.582225,192.168.1.4,192.168.1.5,3557299688,76883605,99,1,26431
67,1574590658.582499,192.168.1.5,192.168.1.4,76883605,3557299787,382,0,26049
68,1574590658.583729,192.168.1.5,192.168.1.4,2343551115,2292309862,121,0,25928
69,1574590658.586778,192.168.1.5,192.168.1.4,1180690329,971671480,343,0,25585
70,1574590658.591603,192.168.1.5,192.168.1.4,1568358124,2103682416,343,0,25242
71,1574590658.592157,192.168.1.4,192.168.1.5,971671480,1180690672,99,1,25341
72,1574590658.592416,192.168.1.5,192.168.1.4,1180690672,971671579,382,0,24959
73,1574590658.593878,192.168.1.5,192.168.1.4,2652299749,236685522,343,0,24616
74,1574590658.595919,192.168.1.5,192.168.1.4,1442186148,1179952968,343,0,24273
75,1574590658.59654,192.168.1.4,192.168.1.5,2103682416,1568358467,99,1,24372
76,1574590658.596799,192.168.1.5,192.168.1.4,1568358467,2103682515,382,0,23990
77,1574590658.597098,192.168.1.4,192.168.1.5,236685522,2652300092,99,1,24089
78,1574590658.597308,192.168.1.5,192.168.1.4,2652300092,236685621,382,0,23707
79,1574590658.598415,192.168.1.4,192.168.1.5,2692663267,2451414799,2266,1,25973
80,1574590658.599266,192.168.1.5,192.168.1.4,2451414799,2692665533,74,0,25899
81,1574590658.599371,192.168.1.5,192.168.1.4,2451414873,2692665533,247,0,25652
82,1574590658.599747,192.168.1.5,192.168.1.4,2343551236,2292309862,117,0,25535
83,1574590658.602569,192.168.1.4,192.168.1.5,1179952968,1442186491,99,1,25634
84,1574590658.602852,192.168.1.5,192.168.1.4,1442186491,1179953067,382,0,25252
85,1574590658.606253,192.168.1.4,192.168.1.5,2692665533,2451415120,79,1,25331
86,1574590658.606279,192.168.1.4,192.168.1.5,2692665612,2451415120,79,1,25410
87,1574590658.616937,192.168.1.4,192.168.1.5,2701674435,3870455218,91,1,25501
88,1574590658.617378,192.168.1.5,192.168.1.4,3870455218,2701674526,598,0,24903
89,1574590658.620974,192.168.1.4,192.168.1.5,3557299787,76883987,2266,1,27169
90,1574590658.621811,192.168.1.5,192.168.1.4,76883987,3557302053,74,0,27095
91,1574590658.621917,192.168.1.5,192.168.1.4,76884061,3557302053,247,0,26848
92,1574590658.628385,192.168.1.4,192.168.1.5,2292309862,2343551353,145,1,26993
93,1574590658.630122,192.168.1.4,192.168.1.5,3557302053,76884308,79,1,27072
94,1574590658.630276,192.168.1.4,192.168.1.5,3557302132,76884308,79,1,27151
95,1574590658.6379,192.168.1.4,192.168.1.5,1179953067,1442186873,2266,1,29417
96,1574590658.638795,192.168.1.5,192.168.1.4,1442186873,1179955333,74,0,29343
97,1574590658.638945,192.168.1.5,192.168.1.4,1442186947,1179955333,237,0,29106
98,1574590658.641333,192.168.1.4,192.168.1.5,2103682515,1568358849,2266,1,31372
99,1574590658.642085,192.168.1.5,192.168.1.4,1568358849,2103684781,74,0,31298
100,1574590658.642231,192.168.1.5,192.168.1.4,1568358923,2103684781,245,0,31053
101,1574590658.642405,192.168.1.4,192.168.1.5,971671579,1180691054,2266,1,33319
102,1574590658.643133,192.168.1.5,192.168.1.4,1180691054,971673845,74,0,33245
103,1574590658.643272,192.168.1.5,192.168.1.4,1180691128,971673845,245,0,33000
104,1574590658.644505,192.168.1.4,192.168.1.5,236685621,2652300474,2266,1,35266
105,1574590658.644722,192.168.1.4,192.168.1.5,971673845,1180691373,79,1,35345
106,1574590658.644792,192.168.1.4,192.168.1.5,971673924,1180691373,79,1,35424
107,1574590658.645438,192.168.1.5,192.168.1.4,2652300474,236687887,74,0,35350
108,1574590658.645547,192.168.1.5,192.168.1.4,2652300548,236687887,245,0,35105
109,1574590658.645927,192.168.1.4,192.168.1.5,2103684781,1568359168,79,1,35184
110,1574590658.645994,192.168.1.4,192.168.1.5,2103684860,1568359168,79,1,35263
111,1574590658.646858,192.168.1.4,192.168.1.5,1179955333,1442187184,79,1,35342
112,1574590658.646918,192.168.1.4,192.168.1.5,1179955412,1442187184,79,1,35421
113,1574590658.647375,192.168.1.4,192.168.1.5,236687887,2652300793,79,1,35500
114,1574590658.647389,192.168.1.4,192.168.1.5,236687966,2652300793,79,1,35579
115,1574590658.648734,192.168.1.4,192.168.1.5,2292310007,2343551353,8688,1,44267
116,1574590658.648808,192.168.1.4,192.168.1.5,2292318695,2343551353,7718,1,51985
117,1574590658.648902,192.168.1.4,192.168.1.5,2292326413,2343551353,4344,1,56329
118,1574590658.649013,192.168.1.4,192.168.1.5,2292330757,2343551353,4344,1,60673
119,1574590658.649097,192.168.1.4,192.168.1.5,2292335101,2343551353,4344,1,65017
120,1574590658.649106,192.168.1.4,192.168.1.5,2292339445,2343551353,3374,1,68391
121,1574590658.64919,192.168.1.4,192.168.1.5,2292342819,2343551353,7240,1,75631
122,1574590658.649445,192.168.1.4,192.168.1.5,2292350059,2343551353,5390,1,81021
123,1574590658.653602,192.168.1.5,192.168.1.4,2343551353,2292355449,61,0,80960
124,1574590658.654256,192.168.1.4,192.168.1.5,2292355449,2343551414,4276,1,85236
125,1574590658.657162,192.168.1.4,192.168.1.5,2701674526,3870455816,234,1,85470
126,1574590658.660891,192.168.1.5,192.168.1.4,3870455816,2701674760,86,0,85384
127,1574590658.677949,192.168.1.4,192.168.1.5,2292359725,2343551414,16406,1,101790
128,1574590658.678064,192.168.1.4,192.168.1.5,2292376131,2343551414,10136,1,111926
129,1574590658.678362,192.168.1.4,192.168.1.5,2292386267,2343551414,6270,1,118196
130,1574590658.678395,192.168.1.4,192.168.1.5,2292392537,2343551414,1286,1,119482
131,1574590658.694918,192.168.1.4,192.168.1.5,2292393823,2343551414,16406,1,135888
132,1574590658.695153,192.168.1.4,192.168.1.5,2292410229,2343551414,16406,1,152294
133,1574590658.699999,192.168.1.4,192.168.1.5,2292426635,2343551414,1916,1,154210
134,1574590658.738447,192.168.1.4,192.168.1.5,2292428551,2343551414,16330,1,170540
135,1574590659.131458,192.168.1.5,192.168.1.4,1716976268,1007775376,343,0,170197
136,1574590659.131921,192.168.1.4,192.168.1.5,1007775376,1716976611,99,1,170296
137,1574590659.132321,192.168.1.5,192.168.1.4,1716976611,1007775475,382,0,169914
138,1574590659.144634,192.168.1.4,192.168.1.5,1007775475,1716976993,2266,1,172180
139,1574590659.145525,192.168.1.5,192.168.1.4,1716976993,1007777741,74,0,172106
140,1574590659.145663,192.168.1.5,192.168.1.4,1716977067,1007777741,237,0,171869
141,1574590659.145909,192.168.1.4,192.168.1.5,1007777741,1716977304,79,1,171948
142,1574590659.146011,192.168.1.4,192.168.1.5,1007777820,1716977304,79,1,172027
143,1574590662.78549,192.168.1.4,192.168.1.5,2692665691,2451415120,91,1,172118
144,1574590662.786112,192.168.1.5,192.168.1.4,2451415120,2692665782,539,0,171579
145,1574590662.825373,192.168.1.4,192.168.1.5,2692665782,2451415659,2070,1,173649
146,1574590662.866533,192.168.1.4,192.168.1.5,2692667852,2451415659,1888,1,175537
147,1574590662.872135,192.168.1.5,192.168.1.4,2451415659,2692669740,86,0,175451
148,1574590662.872442,192.168.1.5,192.168.1.4,2451415745,2692669740,108,0,175343
149,1574590662.874146,192.168.1.5,192.168.1.4,76884308,3557302211,24,0,175319
150,1574590662.876336,192.168.1.5,192.168.1.4,2451415853,2692669740,268,0,175051
151,1574590662.880457,192.168.1.5,192.168.1.4,2451416121,2692669740,138,0,174913
152,1574590662.910667,192.168.1.4,192.168.1.5,2692669740,2451416259,617,1,175530
153,1574590662.911528,192.168.1.5,192.168.1.4,2451416259,2692670357,53,0,175477
154,1574590662.919987,192.168.1.4,192.168.1.5,2692670357,2451416312,883,1,176360
155,1574590662.922007,192.168.1.5,192.168.1.4,2451416312,2692671240,61,0,176299
156,1574590662.923676,192.168.1.4,192.168.1.5,2692671240,2451416373,1173,1,177472
157,1574590662.941676,192.168.1.5,192.168.1.4,2450430474,2927823564,343,0,177129
158,1574590662.942218,192.168.1.4,192.168.1.5,2927823564,2450430817,99,1,177228
159,1574590662.942442,192.168.1.5,192.168.1.4,2450430817,2927823663,382,0,176846
160,1574590662.951782,192.168.1.4,192.168.1.5,2927823663,2450431199,2266,1,179112
161,1574590662.952659,192.168.1.5,192.168.1.4,2450431199,2927825929,74,0,179038
162,1574590662.952797,192.168.1.5,192.168.1.4,2450431273,2927825929,241,0,178797
163,1574590662.953113,192.168.1.4,192.168.1.5,2927825929,2450431514,79,1,178876
164,1574590662.953132,192.168.1.4,192.168.1.5,2927826008,2450431514,79,1,178955
165,1574590662.962973,192.168.1.5,192.168.1.4,15886500,2895379146,343,0,178612
166,1574590662.963422,192.168.1.4,192.168.1.5,2895379146,15886843,99,1,178711
167,1574590662.963762,192.168.1.5,192.168.1.4,15886843,2895379245,382,0,178329
168,1574590662.973193,192.168.1.4,192.168.1.5,2895379245,15887225,2266,1,180595
169,1574590662.974105,192.168.1.5,192.168.1.4,15887225,2895381511,74,0,180521
170,1574590662.974221,192.168.1.5,192.168.1.4,15887299,2895381511,255,0,180266
171,1574590662.974486,192.168.1.4,192.168.1.5,2895381511,15887299,79,1,180345
172,1574590662.974587,192.168.1.4,192.168.1.5,2895381590,15887554,79,1,180424
173,1574590663.091461,192.168.1.4,192.168.1.5,1179955491,1442187184,91,1,180515
174,1574590663.091491,192.168.1.4,192.168.1.5,236688045,2652300793,91,1,180606
175,1574590663.091959,192.168.1.5,192.168.1.4,1442187184,1179955582,539,0,180067
176,1574590663.099868,192.168.1.5,192.168.1.4,2652300793,236688136,539,0,179528
177,1574590663.131215,192.168.1.4,192.168.1.5,1179955582,1442187723,2070,1,181598
178,1574590663.155398,192.168.1.4,192.168.1.5,236688136,2652301332,2070,1,183668
179,1574590663.174241,192.168.1.4,192.168.1.5,1179957652,1442187723,1757,1,185425
180,1574590663.180905,192.168.1.5,192.168.1.4,1442187723,1179959409,86,0,185339
181,1574590663.187016,192.168.1.5,192.168.1.4,1442187809,1179959409,108,0,185231
182,1574590663.188161,192.168.1.5,192.168.1.4,1442187917,1179959409,266,0,184965
183,1574590663.198635,192.168.1.4,192.168.1.5,236690206,2652301332,1889,1,186854
184,1574590663.210228,192.168.1.5,192.168.1.4,2652301332,236692095,86,0,186768
185,1574590663.210654,192.168.1.5,192.168.1.4,2652301418,236692095,108,0,186660
186,1574590663.210946,192.168.1.5,192.168.1.4,1180691373,971674003,24,0,186636
187,1574590663.211138,192.168.1.5,192.168.1.4,1568359168,2103684939,24,0,186612
188,1574590663.212596,192.168.1.5,192.168.1.4,2652301526,236692095,266,0,186346
189,1574590663.212782,192.168.1.5,192.168.1.4,2652301792,236692095,108,0,186238
190,1574590663.212966,192.168.1.5,192.168.1.4,2652301900,236692095,110,0,186128
191,1574590663.217387,192.168.1.4,192.168.1.5,1179959409,1442188183,586,1,186714
192,1574590663.217764,192.168.1.5,192.168.1.4,1442188183,1179959995,53,0,186661
193,1574590663.22305,192.168.1.4,192.168.1.5,1179959995,1442188236,53,1,186714
194,1574590663.243222,192.168.1.4,192.168.1.5,236692095,2652302010,586,1,187300
195,1574590663.243548,192.168.1.5,192.168.1.4,2652302010,236692681,53,0,187247
196,1574590663.245496,192.168.1.5,192.168.1.4,2296331783,3573887677,343,0,186904
197,1574590663.246419,192.168.1.4,192.168.1.5,3573887677,2296332126,99,1,187003
198,1574590663.246792,192.168.1.5,192.168.1.4,2296332126,3573887776,382,0,186621
199,1574590663.249985,192.168.1.4,192.168.1.5,236692681,2652302063,2070,1,188691
200,1574590663.256003,192.168.1.5,192.168.1.4,3807941006,2541999440,343,0,188348
201,1574590663.259163,192.168.1.4,192.168.1.5,3573887776,2296332508,2266,1,190614
202,1574590663.260026,192.168.1.4,192.168.1.5,2541999440,3807941349,99,1,190713
203,1574590663.260345,192.168.1.5,192.168.1.4,2296332508,3573890042,74,0,190639
204,1574590663.260454,192.168.1.5,192.168.1.4,2296332582,3573890042,241,0,190398
205,1574590663.260705,192.168.1.4,192.168.1.5,3573890042,2296332582,79,1,190477
206,1574590663.260895,192.168.1.4,192.168.1.5,3573890121,2296332823,79,1,190556
207,1574590663.26132,192.168.1.5,192.168.1.4,3807941349,2541999539,382,0,190174
208,1574590663.266676,192.168.1.4,192.168.1.5,1179960048,1442188236,6451,1,196625
209,1574590663.268424,192.168.1.5,192.168.1.4,4074280717,14257693,343,0,196282
210,1574590663.272211,192.168.1.4,192.168.1.5,2541999539,3807941731,2266,1,198548
211,1574590663.27285,192.168.1.4,192.168.1.5,14257693,4074281060,99,1,198647
212,1574590663.27333,192.168.1.5,192.168.1.4,3807941731,2542001805,74,0,198573
213,1574590663.273471,192.168.1.5,192.168.1.4,3807941805,2542001805,241,0,198332
214,1574590663.274011,192.168.1.5,192.168.1.4,4074281060,14257792,382,0,197950
215,1574590663.278403,192.168.1.4,192.168.1.5,2542001805,3807942046,79,1,198029
216,1574590663.279394,192.168.1.4,192.168.1.5,2542001884,3807942046,79,1,198108
217,1574590663.286077,192.168.1.4,192.168.1.5,236694751,2652302063,7240,1,205348
218,1574590663.286215,192.168.1.4,192.168.1.5,236701991,2652302063,7240,1,212588
219,1574590663.286278,192.168.1.4,192.168.1.5,236709231,2652302063,7240,1,219828
220,1574590663.286339,192.168.1.4,192.168.1.5,236716471,2652302063,7240,1,227068
221,1574590663.286508,192.168.1.4,192.168.1.5,236723711,2652302063,5089,1,232157
222,1574590663.287517,192.168.1.4,192.168.1.5,14257792,4074281442,2266,1,234423
223,1574590663.288415,192.168.1.5,192.168.1.4,4074281442,14260058,74,0,234349
224,1574590663.288554,192.168.1.5,192.168.1.4,4074281516,14260058,241,0,234108
225,1574590663.288811,192.168.1.4,192.168.1.5,14260058,4074281757,79,1,234187
226,1574590663.288828,192.168.1.4,192.168.1.5,14260137,4074281757,79,1,234266
227,1574590663.307632,192.168.1.4,192.168.1.5,236728800,2652302063,16406,1,250672
228,1574590663.307735,192.168.1.4,192.168.1.5,236745206,2652302063,16406,1,267078
229,1574590663.307753,192.168.1.4,192.168.1.5,236761612,2652302063,656,1,267734
230,1574590663.32403,192.168.1.5,192.168.1.4,1442188236,1179966499,61,0,267673
231,1574590663.325869,192.168.1.5,192.168.1.4,4124308523,2206183888,343,0,267330
232,1574590663.326282,192.168.1.4,192.168.1.5,2206183888,4124308866,99,1,267429
233,1574590663.326645,192.168.1.5,192.168.1.4,4124308866,2206183987,382,0,267047
234,1574590663.328969,192.168.1.5,192.168.1.4,780720461,3638324871,343,0,266704
235,1574590663.330503,192.168.1.5,192.168.1.4,2652302063,236762268,61,0,266643
236,1574590663.330961,192.168.1.4,192.168.1.5,236762268,2652302124,2938,1,269581
237,1574590663.334534,192.168.1.4,192.168.1.5,3638324871,780720804,99,1,269680
238,1574590663.334883,192.168.1.5,192.168.1.4,780720804,3638324970,382,0,269298
239,1574590663.340584,192.168.1.4,192.168.1.5,2206183987,4124309248,2266,1,271564
240,1574590663.341532,192.168.1.5,192.168.1.4,4124309248,2206186253,74,0,271490
241,1574590663.341641,192.168.1.5,192.168.1.4,4124309322,2206186253,241,0,271249
242,1574590663.346614,192.168.1.4,192.168.1.5,2206186253,4124309563,79,1,271328
243,1574590663.346639,192.168.1.4,192.168.1.5,2206186332,4124309563,79,1,271407
244,1574590663.347966,192.168.1.4,192.168.1.5,3638324970,780721186,2266,1,273673
245,1574590663.34895,192.168.1.5,192.168.1.4,780721186,3638327236,74,0,273599
246,1574590663.349242,192.168.1.4,192.168.1.5,3638327236,780721260,79,1,273678
247,1574590663.349305,192.168.1.4,192.168.1.5,3638327315,780721260,79,1,273757
248,1574590663.349756,192.168.1.5,192.168.1.4,780721260,3638327394,241,0,273516
249,1574590663.38137,192.168.1.4,192.168.1.5,3557302211,76884332,91,1,273607
250,1574590663.381393,192.168.1.4,192.168.1.5,3557302302,76884332,24,1,273631
251,1574590663.3818,192.168.1.4,192.168.1.5,2103684939,1568359192,91,1,273722
252,1574590663.381897,192.168.1.4,192.168.1.5,2103685030,1568359192,24,1,273746
253,1574590663.650475,192.168.1.4,192.168.1.5,1007777899,1716977304,91,1,273837
254,1574590663.650529,192.168.1.4,192.168.1.5,971674003,1180691397,91,1,273928
255,1574590663.651356,192.168.1.4,192.168.1.5,971674094,1180691397,24,1,273952
256,1574590663.652974,192.168.1.5,192.168.1.4,1716977304,1007777990,539,0,273413
257,1574590663.971096,192.168.1.4,192.168.1.5,1007777990,1716977843,2070,1,275483
258,1574590664.014703,192.168.1.4,192.168.1.5,1007780060,1716977843,1756,1,277239
259,1574590664.023889,192.168.1.5,192.168.1.4,1716977843,1007781816,86,0,277153
260,1574590664.024464,192.168.1.5,192.168.1.4,1716977929,1007781816,108,0,277045
261,1574590664.025009,192.168.1.5,192.168.1.4,1716978037,1007781816,279,0,276766
262,1574590664.057039,192.168.1.4,192.168.1.5,1007781816,1716978316,586,1,277352
263,1574590664.057572,192.168.1.5,192.168.1.4,1716978316,1007782402,53,0,277299
264,1574590664.081709,192.168.1.4,192.168.1.5,1007782402,1716978369,2070,1,279369
265,1574590664.122606,192.168.1.4,192.168.1.5,1007784472,1716978369,863,1,280232
266,1574590664.123517,192.168.1.5,192.168.1.4,1716978369,1007785335,61,0,280171
267,1574590665.178753,192.168.1.4,192.168.1.5,2895381669,15887554,91,1,280262
268,1574590665.179064,192.168.1.4,192.168.1.5,2927826087,2450431514,91,1,280353
269,1574590665.179685,192.168.1.4,192.168.1.5,14260216,4074281757,91,1,280444
270,1574590665.182263,192.168.1.5,192.168.1.4,15887554,2895381760,539,0,279905
271,1574590665.183201,192.168.1.5,192.168.1.4,2450431514,2927826178,539,0,279366
272,1574590665.184019,192.168.1.5,192.168.1.4,4074281757,14260307,539,0,278827
273,1574590665.224357,192.168.1.4,192.168.1.5,2927826178,2450432053,2070,1,280897
274,1574590665.224576,192.168.1.4,192.168.1.5,2895381760,15888093,2070,1,282967
275,1574590665.226435,192.168.1.4,192.168.1.5,14260307,4074282296,1440,1,284407
276,1574590665.266448,192.168.1.4,192.168.1.5,2895383830,15888093,1249,1,285656
277,1574590665.266479,192.168.1.4,192.168.1.5,2927828248,2450432053,1756,1,287412
278,1574590665.270598,192.168.1.4,192.168.1.5,14261747,4074282296,2387,1,289799
279,1574590665.276246,192.168.1.5,192.168.1.4,15888093,2895385079,86,0,289713
280,1574590665.276581,192.168.1.5,192.168.1.4,15888179,2895385079,108,0,289605
281,1574590665.277282,192.168.1.5,192.168.1.4,15888287,2895385079,259,0,289346
282,1574590665.27901,192.168.1.5,192.168.1.4,2450432053,2927830004,86,0,289260
283,1574590665.28142,192.168.1.5,192.168.1.4,4074282296,14264134,86,0,289174
284,1574590665.285706,192.168.1.5,192.168.1.4,4074282382,14264134,24,0,289150
285,1574590665.286136,192.168.1.4,192.168.1.5,14264134,4074282406,24,1,289174
286,1574590665.287754,192.168.1.5,192.168.1.4,2953517524,3961320851,343,0,288831
287,1574590665.288053,192.168.1.4,192.168.1.5,3961320851,2953517867,99,1,288930
288,1574590665.288495,192.168.1.5,192.168.1.4,2953517867,3961320950,382,0,288548
289,1574590665.288915,192.168.1.5,192.168.1.4,2450432139,2927830004,108,0,288440
290,1574590665.289309,192.168.1.5,192.168.1.4,2296332823,3573890200,24,0,288416
291,1574590665.289538,192.168.1.5,192.168.1.4,3807942046,2542001963,24,0,288392
292,1574590665.289724,192.168.1.5,192.168.1.4,4124309563,2206186411,24,0,288368
293,1574590665.289927,192.168.1.5,192.168.1.4,780721501,3638327394,24,0,288344
294,1574590665.297657,192.168.1.5,192.168.1.4,2450432247,2927830004,381,0,287963
295,1574590665.298372,192.168.1.5,192.168.1.4,2450432628,2927830004,115,0,287848
296,1574590665.298579,192.168.1.5,192.168.1.4,2450432743,2927830004,118,0,287730
297,1574590665.298811,192.168.1.5,192.168.1.4,2450432861,2927830004,110,0,287620
298,1574590665.29896,192.168.1.5,192.168.1.4,2450432971,2927830004,109,0,287511
299,1574590665.299129,192.168.1.5,192.168.1.4,2450433080,2927830004,109,0,287402
300,1574590665.299278,192.168.1.5,192.168.1.4,2450433189,2927830004,109,0,287293
301,1574590665.299423,192.168.1.5,192.168.1.4,2450433298,2927830004,107,0,287186
302,1574590665.301239,192.168.1.4,192.168.1.5,3638327394,780721525,91,1,287277
303,1574590665.301259,192.168.1.4,192.168.1.5,3638327485,780721525,24,1,287301
304,1574590665.306757,192.168.1.4,192.168.1.5,3961320950,2953518249,2266,1,289567
305,1574590665.308463,192.168.1.5,192.168.1.4,2953518249,3961323216,74,0,289493
306,1574590665.308653,192.168.1.5,192.168.1.4,2953518323,3961323216,241,0,289252
307,1574590665.308709,192.168.1.5,192.168.1.4,2953518564,3961323216,24,0,289228
308,1574590665.308862,192.168.1.4,192.168.1.5,3961323216,2953518564,79,1,289307
309,1574590665.30898,192.168.1.4,192.168.1.5,3961323295,2953518588,79,1,289386
310,1574590665.314583,192.168.1.4,192.168.1.5,2895385079,15888546,617,1,290003
311,1574590665.314616,192.168.1.4,192.168.1.5,2927830004,2450433405,586,1,290589
312,1574590665.315414,192.168.1.5,192.168.1.4,15888546,2895385696,53,0,290536
313,1574590665.315609,192.168.1.5,192.168.1.4,2450433405,2927830590,53,0,290483
314,1574590665.321414,192.168.1.4,192.168.1.5,2895385696,15888599,2070,1,292553
315,1574590665.323239,192.168.1.4,192.168.1.5,2927830590,2450433458,53,1,292606
316,1574590665.362522,192.168.1.4,192.168.1.5,2895387766,15888599,14480,1,307086
317,1574590665.362946,192.168.1.4,192.168.1.5,2895402246,15888599,9204,1,316290
318,1574590665.36634,192.168.1.4,192.168.1.5,2927830643,2450433458,8688,1,324978
319,1574590665.366572,192.168.1.4,192.168.1.5,2927839331,2450433458,5792,1,330770
320,1574590665.366696,192.168.1.4,192.168.1.5,2927845123,2450433458,1926,1,332696
321,1574590665.366888,192.168.1.4,192.168.1.5,2927847049,2450433458,7240,1,339936
322,1574590665.367079,192.168.1.4,192.168.1.5,2927854289,2450433458,3709,1,343645
323,1574590665.376963,192.168.1.5,192.168.1.4,15888599,2895411450,61,0,343584
324,1574590665.387311,192.168.1.4,192.168.1.5,2927857998,2450433458,16406,1,359990
325,1574590665.387557,192.168.1.4,192.168.1.5,2927874404,2450433458,5792,1,365782
326,1574590665.388418,192.168.1.4,192.168.1.5,2927880196,2450433458,11900,1,377682
327,1574590665.389838,192.168.1.4,192.168.1.5,2927892096,2450433458,2858,1,380540
328,1574590665.394266,192.168.1.5,192.168.1.4,2450433458,2927894954,61,0,380479
329,1574590665.396014,192.168.1.4,192.168.1.5,2927894954,2450433519,1440,1,381919
330,1574590665.412607,192.168.1.4,192.168.1.5,2927896394,2450433519,11584,1,393503
331,1574590665.412768,192.168.1.4,192.168.1.5,2927907978,2450433519,4822,1,398325
332,1574590665.412827,192.168.1.4,192.168.1.5,2927912800,2450433519,11584,1,409909
333,1574590665.412946,192.168.1.4,192.168.1.5,2927924384,2450433519,10362,1,420271
334,1574590665.425683,192.168.1.4,192.168.1.5,2927934746,2450433519,16406,1,436677
335,1574590665.425793,192.168.1.4,192.168.1.5,2927951152,2450433519,7240,1,443917
336,1574590665.425995,192.168.1.4,192.168.1.5,2927958392,2450433519,9166,1,453083
337,1574590665.426025,192.168.1.4,192.168.1.5,2927967558,2450433519,498,1,453581
338,1574590665.449585,192.168.1.4,192.168.1.5,3573890200,2296332847,91,1,453672
339,1574590665.449606,192.168.1.4,192.168.1.5,3573890291,2296332847,24,1,453696
340,1574590665.450126,192.168.1.4,192.168.1.5,2206186411,4124309587,91,1,453787
341,1574590665.450272,192.168.1.4,192.168.1.5,2206186502,4124309587,24,1,453811
342,1574590665.45028,192.168.1.4,192.168.1.5,2542001963,3807942070,91,1,453902
343,1574590665.450286,192.168.1.4,192.168.1.5,2542002054,3807942070,24,1,453926
344,1574590665.466317,192.168.1.4,192.168.1.5,2927968056,2450433519,3877,1,457803
345,1574590665.481397,192.168.1.5,192.168.1.4,4083529413,555162745,343,0,457460
346,1574590665.481872,192.168.1.4,192.168.1.5,555162745,4083529756,99,1,457559
347,1574590665.482284,192.168.1.5,192.168.1.4,4083529756,555162844,382,0,457177
348,1574590665.491809,192.168.1.4,192.168.1.5,555162844,4083530138,2266,1,459443
349,1574590665.492699,192.168.1.5,192.168.1.4,4083530138,555165110,74,0,459369
350,1574590665.492813,192.168.1.5,192.168.1.4,4083530212,555165110,255,0,459114
351,1574590665.493087,192.168.1.4,192.168.1.5,555165110,4083530212,79,1,459193
352,1574590665.49316,192.168.1.4,192.168.1.5,555165189,4083530467,79,1,459272
353,1574590665.543604,192.168.1.5,192.168.1.4,2450433519,2927971933,109,0,459163
354,1574590665.577008,192.168.1.4,192.168.1.5,2927971933,2450433628,1569,1,460732
355,1574590665.579884,192.168.1.4,192.168.1.5,2927973502,2450433628,4208,1,464940
356,1574590665.580521,192.168.1.5,192.168.1.4,2450433628,2927977710,61,0,464879
357,1574590667.205394,192.168.1.4,192.168.1.5,3961323374,2953518588,91,1,464970
358,1574590667.20564,192.168.1.4,192.168.1.5,3961323465,2953518588,24,1,464994
359,1574590667.327901,192.168.1.4,192.168.1.5,555165268,4083530467,91,1,465085
360,1574590667.328683,192.168.1.5,192.168.1.4,4083530467,555165359,539,0,464546
361,1574590667.369191,192.168.1.4,192.168.1.5,555165359,4083531006,2070,1,466616
362,1574590667.410504,192.168.1.4,192.168.1.5,555167429,4083531006,1249,1,467865
363,1574590667.414562,192.168.1.5,192.168.1.4,4083531006,555168678,86,0,467779
364,1574590667.415289,192.168.1.5,192.168.1.4,4083531092,555168678,108,0,467671
365,1574590667.416236,192.168.1.5,192.168.1.4,4083531200,555168678,250,0,467421
366,1574590667.463204,192.168.1.4,192.168.1.5,555168678,4083531450,2070,1,469491
367,1574590667.465409,192.168.1.5,192.168.1.4,4083531450,555170748,53,0,469438
368,1574590667.46623,192.168.1.4,192.168.1.5,555170748,4083531503,7240,1,476678
369,1574590667.466511,192.168.1.4,192.168.1.5,555177988,4083531503,1611,1,478289
370,1574590667.506604,192.168.1.4,192.168.1.5,555179599,4083531503,8242,1,486531
371,1574590667.508211,192.168.1.5,192.168.1.4,4083531503,555187841,61,0,486470
372,1574590667.555073,192.168.1.5,192.168.1.4,4083531564,555187841,451,0,486019
373,1574590667.557212,192.168.1.5,192.168.1.4,4083532015,555187841,465,0,485554
374,1574590667.559053,192.168.1.5,192.168.1.4,4083532480,555187841,465,0,485089
375,1574590667.564902,192.168.1.5,192.168.1.4,4083532945,555187841,464,0,484625
376,1574590667.599397,192.168.1.4,192.168.1.5,555187841,4083533409,302,1,484927
377,1574590667.602302,192.168.1.5,192.168.1.4,4083533409,555188143,61,0,484866
378,1574590667.602874,192.168.1.4,192.168.1.5,555188143,4083533470,159,1,485025
379,1574590667.646632,192.168.1.4,192.168.1.5,555188302,4083533470,902,1,485927
380,1574590667.656023,192.168.1.5,192.168.1.4,2849516030,1194503392,343,0,485584
381,1574590667.656715,192.168.1.4,192.168.1.5,1194503392,2849516373,99,1,485683
382,1574590667.65753,192.168.1.5,192.168.1.4,2849516373,1194503491,382,0,485301
383,1574590667.668641,192.168.1.4,192.168.1.5,1194503491,2849516755,2266,1,487567
384,1574590667.669553,192.168.1.5,192.168.1.4,2849516755,1194505757,74,0,487493
385,1574590667.669709,192.168.1.5,192.168.1.4,2849516829,1194505757,253,0,487240
386,1574590667.669987,192.168.1.4,192.168.1.5,1194505757,2849517082,79,1,487319
387,1574590667.670109,192.168.1.4,192.168.1.5,1194505836,2849517082,79,1,487398
388,1574590667.801037,192.168.1.4,192.168.1.5,2701674760,3870455902,24,1,487422
389,1574590668.909412,192.168.1.4,192.168.1.5,1194505915,2849517082,91,1,487513
390,1574590668.91028,192.168.1.5,192.168.1.4,2849517082,1194506006,539,0,486974
391,1574590668.955808,192.168.1.4,192.168.1.5,1194506006,2849517621,2070,1,489044
392,1574590668.998513,192.168.1.4,192.168.1.5,1194508076,2849517621,809,1,489853
393,1574590669.003348,192.168.1.5,192.168.1.4,2849517621,1194508885,86,0,489767
394,1574590669.003762,192.168.1.5,192.168.1.4,2849517707,1194508885,108,0,489659
395,1574590669.004241,192.168.1.5,192.168.1.4,2849517815,1194508885,378,0,489281
396,1574590669.045757,192.168.1.4,192.168.1.5,1194508885,2849518193,1129,1,490410
397,1574590669.051421,192.168.1.5,192.168.1.4,2849518193,1194510014,53,0,490357
398,1574590669.051771,192.168.1.5,192.168.1.4,2849518246,1194510014,61,0,490296
399,1574590669.064213,192.168.1.5,192.168.1.4,3870455902,2701674784,24,0,490272
400,1574590669.066337,192.168.1.5,192.168.1.4,1333249036,3921044306,343,0,489929
401,1574590669.066694,192.168.1.4,192.168.1.5,3921044306,1333249379,99,1,490028
402,1574590669.067051,192.168.1.5,192.168.1.4,1333249379,3921044405,382,0,489646
403,1574590669.077025,192.168.1.4,192.168.1.5,3921044405,1333249761,2266,1,491912
404,1574590669.077936,192.168.1.5,192.168.1.4,1333249761,3921046671,74,0,491838
405,1574590669.078063,192.168.1.5,192.168.1.4,1333249835,3921046671,251,0,491587
406,1574590669.078415,192.168.1.4,192.168.1.5,3921046671,1333250086,79,1,491666
407,1574590669.079824,192.168.1.4,192.168.1.5,3921046750,1333250086,79,1,491745
408,1574590669.739516,192.168.1.5,192.168.1.4,2285430694,1842745538,24,0,491721
409,1574590669.740105,192.168.1.4,192.168.1.5,1842745538,2285430718,24,1,491745
410,1574590669.74123,192.168.1.5,192.168.1.4,15888660,2895411450,24,0,491721
411,1574590669.741597,192.168.1.4,192.168.1.5,2895411450,15888684,24,1,491745
412,1574590669.742529,192.168.1.5,192.168.1.4,2450433689,2927977710,24,0,491721
413,1574590669.742776,192.168.1.5,192.168.1.4,2343551414,2292444881,24,0,491697
414,1574590669.742838,192.168.1.4,192.168.1.5,2927977710,2450433713,24,1,491721
415,1574590669.743429,192.168.1.4,192.168.1.5,2292444881,2343551438,24,1,491745
416,1574590669.744347,192.168.1.5,192.168.1.4,4083533470,555189204,24,0,491721
417,1574590669.74452,192.168.1.5,192.168.1.4,2849518307,1194510014,24,0,491697
418,1574590669.744712,192.168.1.5,192.168.1.4,2652302124,236765206,24,0,491673
419,1574590669.744752,192.168.1.4,192.168.1.5,1194510014,2849518331,24,1,491697
420,1574590669.745272,192.168.1.4,192.168.1.5,236765206,2652302148,24,1,491721
421,1574590669.745348,192.168.1.4,192.168.1.5,555189204,4083533494,24,1,491745
422,1574590669.746819,192.168.1.5,192.168.1.4,1442188297,1179966499,24,0,491721
423,1574590669.747021,192.168.1.5,192.168.1.4,2451416373,2692672413,24,0,491697
424,1574590669.747258,192.168.1.4,192.168.1.5,1179966499,1442188321,24,1,491721
425,1574590669.747762,192.168.1.4,192.168.1.5,2692672413,2451416397,24,1,491745
426,1574590669.749269,192.168.1.5,192.168.1.4,1333250086,3921046829,24,0,491721
427,1574590669.750202,192.168.1.5,192.168.1.4,1716978430,1007785335,24,0,491697
428,1574590669.750797,192.168.1.4,192.168.1.5,1007785335,1716978454,24,1,491721
