index,time,src_ip,dst_ip,tcp_seq,tcp_ack,tcp_len,direction,cumul_sum
1,1574591898.24106,192.168.1.4,192.168.1.5,2941271245,1516192401,91,1,91
2,1574591898.241114,192.168.1.4,192.168.1.5,2941271336,1516192401,24,1,115
3,1574591898.395837,192.168.1.4,192.168.1.5,2948677306,1964398588,91,1,206
4,1574591898.395895,192.168.1.4,192.168.1.5,2948677397,1964398588,24,1,230
5,1574591898.666742,192.168.1.4,192.168.1.5,1064162602,3482169337,91,1,321
6,1574591898.667042,192.168.1.4,192.168.1.5,1064162693,3482169337,24,1,345
7,1574591898.967167,192.168.1.4,192.168.1.5,405900632,3193070974,91,1,436
8,1574591898.967284,192.168.1.4,192.168.1.5,405900723,3193070974,24,1,460
9,1574591901.425949,192.168.1.5,192.168.1.4,1708076978,1034693967,343,0,117
10,1574591901.426655,192.168.1.4,192.168.1.5,1034693967,1708077321,99,1,216
11,1574591901.4273,192.168.1.5,192.168.1.4,1708077321,1034694066,382,0,-166
12,1574591901.444479,192.168.1.4,192.168.1.5,1034694066,1708077703,2266,1,2100
13,1574591901.445367,192.168.1.5,192.168.1.4,1708077703,1034696332,74,0,2026
14,1574591901.445558,192.168.1.5,192.168.1.4,1708077777,1034696332,245,0,1781
15,1574591901.445848,192.168.1.4,192.168.1.5,1034696332,1708078022,79,1,1860
16,1574591901.445928,192.168.1.4,192.168.1.5,1034696411,1708078022,79,1,1939
17,1574591901.589647,192.168.1.5,192.168.1.4,1481805858,4102786795,343,0,1596
18,1574591901.590165,192.168.1.4,192.168.1.5,4102786795,1481806201,99,1,1695
19,1574591901.590496,192.168.1.5,192.168.1.4,1481806201,4102786894,382,0,1313
20,1574591901.59248,192.168.1.5,192.168.1.4,1272079707,233809998,343,0,970
21,1574591901.595288,192.168.1.4,192.168.1.5,233809998,1272080050,99,1,1069
22,1574591901.595791,192.168.1.5,192.168.1.4,1272080050,233810097,382,0,687
23,1574591901.618348,192.168.1.4,192.168.1.5,4102786894,1481806583,2266,1,2953
24,1574591901.619975,192.168.1.5,192.168.1.4,1481806583,4102789160,74,0,2879
25,1574591901.620126,192.168.1.5,192.168.1.4,1481806657,4102789160,231,0,2648
26,1574591901.620395,192.168.1.4,192.168.1.5,4102789160,1481806888,79,1,2727
27,1574591901.622911,192.168.1.4,192.168.1.5,4102789239,1481806888,79,1,2806
28,1574591901.622934,192.168.1.4,192.168.1.5,233810097,1272080432,2266,1,5072
29,1574591901.62422,192.168.1.5,192.168.1.4,1272080432,233812363,74,0,4998
30,1574591901.624353,192.168.1.5,192.168.1.4,1272080506,233812363,231,0,4767
31,1574591901.624722,192.168.1.4,192.168.1.5,233812363,1272080737,79,1,4846
32,1574591901.627592,192.168.1.4,192.168.1.5,233812442,1272080737,79,1,4925
33,1574591903.064641,192.168.1.4,192.168.1.5,1034696490,1708078022,91,1,5016
34,1574591903.065177,192.168.1.5,192.168.1.4,1708078022,1034696581,539,0,4477
35,1574591903.115807,192.168.1.4,192.168.1.5,1034696581,1708078561,2070,1,6547
36,1574591903.158547,192.168.1.4,192.168.1.5,1034698651,1708078561,1018,1,7565
37,1574591903.167476,192.168.1.5,192.168.1.4,1708078561,1034699669,86,0,7479
38,1574591903.168081,192.168.1.5,192.168.1.4,1708078647,1034699669,108,0,7371
39,1574591903.16893,192.168.1.5,192.168.1.4,1708078755,1034699669,321,0,7050
40,1574591903.169186,192.168.1.5,192.168.1.4,1708079076,1034699669,54,0,6996
41,1574591903.200046,192.168.1.4,192.168.1.5,1034699669,1708079130,617,1,7613
42,1574591903.200525,192.168.1.5,192.168.1.4,1708079130,1034700286,53,0,7560
43,1574591903.212362,192.168.1.4,192.168.1.5,1034700286,1708079183,1187,1,8747
44,1574591903.213742,192.168.1.5,192.168.1.4,1708079183,1034701473,61,0,8686
45,1574591903.364507,192.168.1.4,192.168.1.5,4102789318,1481806888,91,1,8777
46,1574591903.364532,192.168.1.4,192.168.1.5,233812521,1272080737,91,1,8868
47,1574591903.365593,192.168.1.5,192.168.1.4,1481806888,4102789409,539,0,8329
48,1574591903.365764,192.168.1.5,192.168.1.4,1272080737,233812612,539,0,7790
49,1574591903.407302,192.168.1.4,192.168.1.5,233812612,1272081276,2070,1,9860
50,1574591903.407646,192.168.1.4,192.168.1.5,4102789409,1481807427,2070,1,11930
51,1574591903.450495,192.168.1.4,192.168.1.5,4102791479,1481807427,2712,1,14642
52,1574591903.450596,192.168.1.4,192.168.1.5,233814682,1272081276,2712,1,17354
53,1574591903.456719,192.168.1.5,192.168.1.4,1481807427,4102794191,148,0,17206
54,1574591903.457764,192.168.1.5,192.168.1.4,1272081276,233817394,148,0,17058
55,1574591903.508127,192.168.1.4,192.168.1.5,4102794191,1481807575,73,1,17131
56,1574591903.508853,192.168.1.4,192.168.1.5,233817394,1272081424,73,1,17204
57,1574591903.509657,192.168.1.5,192.168.1.4,1481807575,4102794264,526,0,16678
58,1574591903.55143,192.168.1.4,192.168.1.5,4102794264,1481808101,1470,1,18148
59,1574591903.587963,192.168.1.4,192.168.1.5,4102795734,1481808101,14480,1,32628
60,1574591903.588441,192.168.1.4,192.168.1.5,4102810214,1481808101,17376,1,50004
61,1574591903.588579,192.168.1.4,192.168.1.5,4102827590,1481808101,1295,1,51299
62,1574591903.630427,192.168.1.4,192.168.1.5,4102828885,1481808101,16406,1,67705
63,1574591903.630519,192.168.1.4,192.168.1.5,4102845291,1481808101,8502,1,76207
64,1574591903.654921,192.168.1.5,192.168.1.4,2815065078,502754157,343,0,75864
65,1574591903.655415,192.168.1.4,192.168.1.5,502754157,2815065421,99,1,75963
66,1574591903.655988,192.168.1.5,192.168.1.4,2815065421,502754256,382,0,75581
67,1574591903.65759,192.168.1.5,192.168.1.4,2214389126,4017391276,343,0,75238
68,1574591903.658219,192.168.1.5,192.168.1.4,1272081424,233817467,490,0,74748
69,1574591903.660893,192.168.1.5,192.168.1.4,1550375165,33338803,343,0,74405
70,1574591903.661297,192.168.1.4,192.168.1.5,4017391276,2214389469,99,1,74504
71,1574591903.661599,192.168.1.5,192.168.1.4,2214389469,4017391375,382,0,74122
72,1574591903.66507,192.168.1.5,192.168.1.4,2771424613,1726318573,343,0,73779
73,1574591903.665387,192.168.1.4,192.168.1.5,33338803,1550375508,99,1,73878
74,1574591903.665829,192.168.1.5,192.168.1.4,1550375508,33338902,382,0,73496
75,1574591903.668721,192.168.1.5,192.168.1.4,2588136212,150901022,343,0,73153
76,1574591903.669326,192.168.1.4,192.168.1.5,4102853793,1481808101,956,1,74109
77,1574591903.669892,192.168.1.4,192.168.1.5,1726318573,2771424956,99,1,74208
78,1574591903.670184,192.168.1.5,192.168.1.4,2771424956,1726318672,382,0,73826
79,1574591903.671003,192.168.1.5,192.168.1.4,1481808101,4102854749,463,0,73363
80,1574591903.67391,192.168.1.5,192.168.1.4,3487525154,2180101593,343,0,73020
81,1574591903.674584,192.168.1.4,192.168.1.5,150901022,2588136555,99,1,73119
82,1574591903.674829,192.168.1.5,192.168.1.4,2588136555,150901121,382,0,72737
83,1574591903.679635,192.168.1.5,192.168.1.4,1630710596,2006505421,343,0,72394
84,1574591903.680055,192.168.1.4,192.168.1.5,2180101593,3487525497,99,1,72493
85,1574591903.680442,192.168.1.5,192.168.1.4,3487525497,2180101692,382,0,72111
86,1574591903.693015,192.168.1.4,192.168.1.5,33338902,1550375890,2266,1,74377
87,1574591903.69362,192.168.1.4,192.168.1.5,2006505421,1630710939,99,1,74476
88,1574591903.694146,192.168.1.5,192.168.1.4,1550375890,33341168,74,0,74402
89,1574591903.694259,192.168.1.5,192.168.1.4,1550375964,33341168,231,0,74171
90,1574591903.694721,192.168.1.5,192.168.1.4,1630710939,2006505520,382,0,73789
91,1574591903.697115,192.168.1.4,192.168.1.5,502754256,2815065803,2266,1,76055
92,1574591903.697924,192.168.1.5,192.168.1.4,2815065803,502756522,74,0,75981
93,1574591903.698027,192.168.1.5,192.168.1.4,2815065877,502756522,231,0,75750
94,1574591903.701198,192.168.1.5,192.168.1.4,1076945867,2394393657,343,0,75407
95,1574591903.703324,192.168.1.5,192.168.1.4,1279478878,4190168136,343,0,75064
96,1574591903.706315,192.168.1.4,192.168.1.5,233817467,1272081914,8688,1,83752
97,1574591903.706484,192.168.1.4,192.168.1.5,233826155,1272081914,5792,1,89544
98,1574591903.706515,192.168.1.4,192.168.1.5,233831947,1272081914,1926,1,91470
99,1574591903.706534,192.168.1.4,192.168.1.5,233833873,1272081914,4118,1,95588
100,1574591903.707137,192.168.1.4,192.168.1.5,2394393657,1076946210,99,1,95687
101,1574591903.707453,192.168.1.5,192.168.1.4,1076946210,2394393756,382,0,95305
102,1574591903.709816,192.168.1.5,192.168.1.4,3153701913,3250080370,343,0,94962
103,1574591903.711173,192.168.1.4,192.168.1.5,4102854749,1481808564,2070,1,97032
104,1574591903.712165,192.168.1.5,192.168.1.4,1758336070,1329513796,343,0,96689
105,1574591903.713522,192.168.1.5,192.168.1.4,1550375964,33341168,231,0,96458
106,1574591903.714094,192.168.1.5,192.168.1.4,3127878522,2494156901,343,0,96115
107,1574591903.714544,192.168.1.4,192.168.1.5,4190168136,1279479221,99,1,96214
108,1574591903.715203,192.168.1.5,192.168.1.4,1279479221,4190168235,382,0,95832
109,1574591903.718343,192.168.1.5,192.168.1.4,2030259238,4125538317,343,0,95489
110,1574591903.719996,192.168.1.4,192.168.1.5,3250080370,3153702256,99,1,95588
111,1574591903.72022,192.168.1.4,192.168.1.5,502756522,2815066108,79,1,95667
112,1574591903.720279,192.168.1.4,192.168.1.5,502756601,2815066108,79,1,95746
113,1574591903.720353,192.168.1.5,192.168.1.4,3153702256,3250080469,382,0,95364
114,1574591903.7211,192.168.1.5,192.168.1.4,3348895271,3738548230,343,0,95021
115,1574591903.722859,192.168.1.5,192.168.1.4,2388781522,1033073889,343,0,94678
116,1574591903.724937,192.168.1.4,192.168.1.5,2494156901,3127878865,99,1,94777
117,1574591903.72521,192.168.1.5,192.168.1.4,3127878865,2494157000,382,0,94395
118,1574591903.725608,192.168.1.4,192.168.1.5,1329513796,1758336413,99,1,94494
119,1574591903.725835,192.168.1.5,192.168.1.4,1758336413,1329513895,382,0,94112
120,1574591903.726738,192.168.1.5,192.168.1.4,3080502664,3791844408,343,0,93769
121,1574591903.729112,192.168.1.5,192.168.1.4,2793706200,3600574275,343,0,93426
122,1574591903.730553,192.168.1.4,192.168.1.5,4125538317,2030259581,99,1,93525
123,1574591903.730907,192.168.1.5,192.168.1.4,2030259581,4125538416,382,0,93143
124,1574591903.733032,192.168.1.4,192.168.1.5,4017391375,2214389851,2266,1,95409
125,1574591903.733892,192.168.1.5,192.168.1.4,2214389851,4017393641,74,0,95335
126,1574591903.734001,192.168.1.5,192.168.1.4,2214389925,4017393641,257,0,95078
127,1574591903.742309,192.168.1.4,192.168.1.5,3738548230,3348895614,99,1,95177
128,1574591903.742609,192.168.1.5,192.168.1.4,3348895614,3738548329,382,0,94795
129,1574591903.746261,192.168.1.4,192.168.1.5,233837991,1272081914,4357,1,99152
130,1574591903.746899,192.168.1.4,192.168.1.5,1033073889,2388781865,99,1,99251
131,1574591903.74725,192.168.1.5,192.168.1.4,2388781865,1033073988,382,0,98869
132,1574591903.747759,192.168.1.5,192.168.1.4,1272081914,233842348,477,0,98392
133,1574591903.758203,192.168.1.4,192.168.1.5,4190168235,1279479603,2266,1,100658
134,1574591903.758502,192.168.1.4,192.168.1.5,4102856819,1481808564,3795,1,104453
135,1574591903.759185,192.168.1.5,192.168.1.4,1279479603,4190170501,74,0,104379
136,1574591903.759324,192.168.1.5,192.168.1.4,1279479677,4190170501,225,0,104154
137,1574591903.764276,192.168.1.4,192.168.1.5,3791844408,3080503007,99,1,104253
138,1574591903.764718,192.168.1.5,192.168.1.4,3080503007,3791844507,382,0,103871
139,1574591903.765183,192.168.1.4,192.168.1.5,3600574275,2793706543,99,1,103970
140,1574591903.765441,192.168.1.5,192.168.1.4,2793706543,3600574374,382,0,103588
141,1574591903.770709,192.168.1.4,192.168.1.5,2180101692,3487525879,2266,1,105854
142,1574591903.772167,192.168.1.5,192.168.1.4,3487525879,2180103958,74,0,105780
143,1574591903.772444,192.168.1.5,192.168.1.4,3487525953,2180103958,235,0,105545
144,1574591903.780337,192.168.1.4,192.168.1.5,3600574374,2793706925,2266,1,107811
145,1574591903.781206,192.168.1.5,192.168.1.4,2793706925,3600576640,74,0,107737
146,1574591903.781354,192.168.1.5,192.168.1.4,2793706999,3600576640,231,0,107506
147,1574591903.788482,192.168.1.4,192.168.1.5,233842348,1272082391,2070,1,109576
148,1574591903.795099,192.168.1.4,192.168.1.5,4102860614,1481808564,1275,1,110851
149,1574591903.795335,192.168.1.4,192.168.1.5,4017393641,2214390182,79,1,110930
150,1574591903.795346,192.168.1.4,192.168.1.5,4017393720,2214390182,79,1,111009
151,1574591903.797268,192.168.1.5,192.168.1.4,1481808564,4102861889,491,0,110518
152,1574591903.800191,192.168.1.4,192.168.1.5,1726318672,2771425338,2266,1,112784
153,1574591903.80036,192.168.1.4,192.168.1.5,33341168,1550376195,79,1,112863
154,1574591903.80048,192.168.1.4,192.168.1.5,33341247,1550376195,79,1,112942
155,1574591903.801347,192.168.1.5,192.168.1.4,2771425338,1726320938,74,0,112868
156,1574591903.801435,192.168.1.5,192.168.1.4,2793706999,3600576640,231,0,112637
157,1574591903.802067,192.168.1.5,192.168.1.4,2771425412,1726320938,231,0,112406
158,1574591903.808643,192.168.1.4,192.168.1.5,1329513895,1758336795,2266,1,114672
159,1574591903.809516,192.168.1.5,192.168.1.4,1758336795,1329516161,74,0,114598
160,1574591903.809703,192.168.1.5,192.168.1.4,1758336869,1329516161,249,0,114349
161,1574591903.819731,192.168.1.4,192.168.1.5,4125538416,2030259963,2266,1,116615
162,1574591903.820753,192.168.1.5,192.168.1.4,2030259963,4125540682,74,0,116541
163,1574591903.821251,192.168.1.5,192.168.1.4,2030260037,4125540682,239,0,116302
164,1574591903.828428,192.168.1.4,192.168.1.5,3738548329,3348895996,2266,1,118568
165,1574591903.829286,192.168.1.5,192.168.1.4,3348895996,3738550595,74,0,118494
166,1574591903.829492,192.168.1.5,192.168.1.4,3348896070,3738550595,239,0,118255
167,1574591903.830373,192.168.1.4,192.168.1.5,233844418,1272082391,16406,1,134661
168,1574591903.830467,192.168.1.4,192.168.1.5,233860824,1272082391,7683,1,142344
169,1574591903.831535,192.168.1.4,192.168.1.5,150901121,2588136937,2266,1,144610
170,1574591903.831727,192.168.1.4,192.168.1.5,1726320938,2771425643,79,1,144689
171,1574591903.83183,192.168.1.4,192.168.1.5,1726321017,2771425643,79,1,144768
172,1574591903.832842,192.168.1.4,192.168.1.5,2180103958,3487526188,79,1,144847
173,1574591903.83286,192.168.1.4,192.168.1.5,2180104037,3487526188,79,1,144926
174,1574591903.83306,192.168.1.5,192.168.1.4,2588136937,150903387,74,0,144852
175,1574591903.834511,192.168.1.4,192.168.1.5,150903387,2588137011,79,1,144931
176,1574591903.834525,192.168.1.4,192.168.1.5,150903466,2588137011,79,1,145010
177,1574591903.834894,192.168.1.5,192.168.1.4,2588137011,150903545,231,0,144779
178,1574591903.837482,192.168.1.4,192.168.1.5,4102861889,1481809055,2070,1,146849
179,1574591903.84292,192.168.1.4,192.168.1.5,2394393756,1076946592,2266,1,149115
180,1574591903.843843,192.168.1.5,192.168.1.4,1076946592,2394396022,74,0,149041
181,1574591903.844095,192.168.1.5,192.168.1.4,1076946666,2394396022,241,0,148800
182,1574591903.848231,192.168.1.4,192.168.1.5,2494157000,3127879247,2266,1,151066
183,1574591903.849099,192.168.1.5,192.168.1.4,3127879247,2494159266,74,0,150992
184,1574591903.849247,192.168.1.5,192.168.1.4,3127879321,2494159266,267,0,150725
185,1574591903.852846,192.168.1.4,192.168.1.5,3791844507,3080503389,2266,1,152991
186,1574591903.853113,192.168.1.4,192.168.1.5,2006505520,1630711321,2266,1,155257
187,1574591903.853802,192.168.1.5,192.168.1.4,3080503389,3791846773,74,0,155183
188,1574591903.853967,192.168.1.5,192.168.1.4,3080503463,3791846773,251,0,154932
189,1574591903.855323,192.168.1.5,192.168.1.4,1630711321,2006507786,74,0,154858
190,1574591903.855462,192.168.1.5,192.168.1.4,1630711395,2006507786,247,0,154611
191,1574591903.855783,192.168.1.4,192.168.1.5,2006507786,1630711642,79,1,154690
192,1574591903.855908,192.168.1.4,192.168.1.5,2006507865,1630711642,79,1,154769
193,1574591903.858654,192.168.1.4,192.168.1.5,4190170501,1279479902,79,1,154848
194,1574591903.858679,192.168.1.4,192.168.1.5,4190170580,1279479902,79,1,154927
195,1574591903.860992,192.168.1.4,192.168.1.5,4125540682,2030260276,79,1,155006
196,1574591903.861011,192.168.1.4,192.168.1.5,4125540761,2030260276,79,1,155085
197,1574591903.86145,192.168.1.4,192.168.1.5,2394396022,1076946907,79,1,155164
198,1574591903.861856,192.168.1.4,192.168.1.5,2394396101,1076946907,79,1,155243
199,1574591903.861868,192.168.1.4,192.168.1.5,1329516161,1758337118,79,1,155322
200,1574591903.861877,192.168.1.4,192.168.1.5,1329516240,1758337118,79,1,155401
201,1574591903.862025,192.168.1.4,192.168.1.5,3250080469,3153702638,2266,1,157667
202,1574591903.862333,192.168.1.4,192.168.1.5,2494159266,3127879588,79,1,157746
203,1574591903.862392,192.168.1.4,192.168.1.5,2494159345,3127879588,79,1,157825
204,1574591903.863239,192.168.1.5,192.168.1.4,3153702638,3250082735,74,0,157751
205,1574591903.863368,192.168.1.5,192.168.1.4,3153702712,3250082735,227,0,157524
206,1574591903.863853,192.168.1.4,192.168.1.5,3250082735,3153702939,79,1,157603
207,1574591903.863913,192.168.1.4,192.168.1.5,3250082814,3153702939,79,1,157682
208,1574591903.865502,192.168.1.4,192.168.1.5,3738550595,3348896309,79,1,157761
209,1574591903.865515,192.168.1.4,192.168.1.5,3738550674,3348896309,79,1,157840
210,1574591903.866009,192.168.1.4,192.168.1.5,3600576640,2793707230,79,1,157919
211,1574591903.866546,192.168.1.4,192.168.1.5,3600576719,2793707230,79,1,157998
212,1574591903.867201,192.168.1.4,192.168.1.5,3791846773,3080503714,79,1,158077
213,1574591903.867394,192.168.1.4,192.168.1.5,3791846852,3080503714,79,1,158156
214,1574591903.867773,192.168.1.4,192.168.1.5,1033073988,2388782247,2266,1,160422
215,1574591903.869302,192.168.1.5,192.168.1.4,2388782247,1033076254,74,0,160348
216,1574591903.869698,192.168.1.4,192.168.1.5,1033076254,2388782321,79,1,160427
217,1574591903.869788,192.168.1.4,192.168.1.5,1033076333,2388782321,79,1,160506
218,1574591903.874149,192.168.1.4,192.168.1.5,233868507,1272082391,10385,1,170891
219,1574591903.876207,192.168.1.5,192.168.1.4,2388782321,1033076412,237,0,170654
220,1574591903.877116,192.168.1.5,192.168.1.4,1272082391,233878892,416,0,170238
221,1574591903.878174,192.168.1.4,192.168.1.5,4102863959,1481809055,13032,1,183270
222,1574591903.880692,192.168.1.4,192.168.1.5,4102876991,1481809055,3374,1,186644
223,1574591903.880747,192.168.1.4,192.168.1.5,4102880365,1481809055,6314,1,192958
224,1574591903.917658,192.168.1.4,192.168.1.5,233878892,1272082807,2070,1,195028
225,1574591903.954023,192.168.1.4,192.168.1.5,233880962,1272082807,16406,1,211434
226,1574591903.954102,192.168.1.4,192.168.1.5,233897368,1272082807,2896,1,214330
227,1574591903.954237,192.168.1.4,192.168.1.5,233900264,1272082807,13510,1,227840
228,1574591903.954248,192.168.1.4,192.168.1.5,233913774,1272082807,587,1,228427
229,1574591903.994653,192.168.1.4,192.168.1.5,233914361,1272082807,16406,1,244833
230,1574591903.994713,192.168.1.4,192.168.1.5,233930767,1272082807,2877,1,247710
231,1574591904.006664,192.168.1.5,192.168.1.4,1272082807,233933644,446,0,247264
232,1574591904.049183,192.168.1.4,192.168.1.5,233933644,1272083253,2070,1,249334
233,1574591904.082172,192.168.1.4,192.168.1.5,233935714,1272083253,16406,1,265740
234,1574591904.082273,192.168.1.4,192.168.1.5,233952120,1272083253,16406,1,282146
235,1574591904.082436,192.168.1.4,192.168.1.5,233968526,1272083253,2035,1,284181
236,1574591904.092922,192.168.1.4,192.168.1.5,233970561,1272083253,13032,1,297213
237,1574591904.093111,192.168.1.4,192.168.1.5,233983593,1272083253,3374,1,300587
238,1574591904.093149,192.168.1.4,192.168.1.5,233986967,1272083253,16406,1,316993
239,1574591904.093168,192.168.1.4,192.168.1.5,234003373,1272083253,310,1,317303
240,1574591904.118711,192.168.1.4,192.168.1.5,234003683,1272083253,16406,1,333709
241,1574591904.118838,192.168.1.4,192.168.1.5,234020089,1272083253,16406,1,350115
242,1574591904.118861,192.168.1.4,192.168.1.5,234036495,1272083253,206,1,350321
243,1574591904.154882,192.168.1.4,192.168.1.5,234036701,1272083253,16406,1,366727
244,1574591904.155034,192.168.1.4,192.168.1.5,234053107,1272083253,16406,1,383133
245,1574591904.155213,192.168.1.4,192.168.1.5,234069513,1272083253,1758,1,384891
246,1574591904.19837,192.168.1.4,192.168.1.5,234071271,1272083253,16112,1,401003
247,1574591905.320796,192.168.1.5,192.168.1.4,1272083253,234087383,410,0,400593
248,1574591905.391959,192.168.1.4,192.168.1.5,234087383,1272083663,798,1,401391
249,1574591905.766747,192.168.1.5,192.168.1.4,3406481757,3755080641,343,0,401048
250,1574591905.767128,192.168.1.4,192.168.1.5,3755080641,3406482100,99,1,401147
251,1574591905.767692,192.168.1.5,192.168.1.4,3406482100,3755080740,382,0,400765
252,1574591905.777098,192.168.1.4,192.168.1.5,3755080740,3406482482,2266,1,403031
253,1574591905.77809,192.168.1.5,192.168.1.4,3406482482,3755083006,74,0,402957
254,1574591905.778236,192.168.1.5,192.168.1.4,3406482556,3755083006,237,0,402720
255,1574591905.778473,192.168.1.4,192.168.1.5,3755083006,3406482793,79,1,402799
256,1574591905.778556,192.168.1.4,192.168.1.5,3755083085,3406482793,79,1,402878
257,1574591909.174594,192.168.1.4,192.168.1.5,502756680,2815066108,91,1,402969
258,1574591909.175288,192.168.1.5,192.168.1.4,2815066108,502756771,539,0,402430
259,1574591909.211979,192.168.1.4,192.168.1.5,502756771,2815066647,169,1,402599
260,1574591909.212715,192.168.1.5,192.168.1.4,2815066647,502756940,73,0,402526
261,1574591909.401886,192.168.1.4,192.168.1.5,33341326,1550376195,91,1,402617
262,1574591909.402312,192.168.1.5,192.168.1.4,1550376195,33341417,539,0,402078
263,1574591909.44199,192.168.1.4,192.168.1.5,33341417,1550376734,169,1,402247
264,1574591909.442458,192.168.1.5,192.168.1.4,1550376734,33341586,73,0,402174
265,1574591909.909764,192.168.1.4,192.168.1.5,1033076412,2388782558,91,1,402265
266,1574591909.909794,192.168.1.4,192.168.1.5,2180104116,3487526188,91,1,402356
267,1574591909.911526,192.168.1.5,192.168.1.4,3487526188,2180104207,539,0,401817
268,1574591909.911787,192.168.1.5,192.168.1.4,2388782558,1033076503,539,0,401278
269,1574591909.947851,192.168.1.4,192.168.1.5,2180104207,3487526727,2070,1,403348
270,1574591909.948415,192.168.1.4,192.168.1.5,1033076503,2388783097,2070,1,405418
271,1574591909.990657,192.168.1.4,192.168.1.5,1033078573,2388783097,1784,1,407202
272,1574591909.990714,192.168.1.4,192.168.1.5,2180106277,3487526727,2865,1,410067
273,1574591909.994949,192.168.1.5,192.168.1.4,2388783097,1033080357,148,0,409919
274,1574591910.009672,192.168.1.5,192.168.1.4,3487526727,2180109142,148,0,409771
275,1574591910.01111,192.168.1.5,192.168.1.4,3487526875,2180109142,410,0,409361
276,1574591910.018887,192.168.1.4,192.168.1.5,2494159424,3127879588,91,1,409452
277,1574591910.019304,192.168.1.5,192.168.1.4,3127879588,2494159515,539,0,408913
278,1574591910.026166,192.168.1.4,192.168.1.5,1033080357,2388783245,280,1,409193
279,1574591910.043582,192.168.1.4,192.168.1.5,2180109142,3487527285,280,1,409473
280,1574591910.052684,192.168.1.4,192.168.1.5,3738550753,3348896309,91,1,409564
281,1574591910.053102,192.168.1.5,192.168.1.4,3348896309,3738550844,539,0,409025
282,1574591910.059736,192.168.1.4,192.168.1.5,2494159515,3127880127,2070,1,411095
283,1574591910.086403,192.168.1.4,192.168.1.5,2180109422,3487527285,9053,1,420148
284,1574591910.088347,192.168.1.4,192.168.1.5,3738550844,3348896848,2070,1,422218
285,1574591910.102273,192.168.1.4,192.168.1.5,2494161585,3127880127,809,1,423027
286,1574591910.104691,192.168.1.5,192.168.1.4,3127880127,2494162394,86,0,422941
287,1574591910.130291,192.168.1.4,192.168.1.5,3738552914,3348896848,4757,1,427698
288,1574591910.137694,192.168.1.4,192.168.1.5,2494162394,3127880213,586,1,428284
289,1574591910.148345,192.168.1.5,192.168.1.4,3348896848,3738557671,115,0,428169
290,1574591910.164407,192.168.1.4,192.168.1.5,1726321096,2771425643,91,1,428260
291,1574591910.164428,192.168.1.4,192.168.1.5,3791846931,3080503714,91,1,428351
292,1574591910.164433,192.168.1.4,192.168.1.5,2006507944,1630711642,91,1,428442
293,1574591910.165123,192.168.1.5,192.168.1.4,1630711642,2006508035,539,0,427903
294,1574591910.165245,192.168.1.5,192.168.1.4,3080503714,3791847022,539,0,427364
295,1574591910.165308,192.168.1.5,192.168.1.4,2771425643,1726321187,539,0,426825
296,1574591910.179304,192.168.1.4,192.168.1.5,3738557671,3348896963,280,1,427105
297,1574591910.190591,192.168.1.4,192.168.1.5,2006508035,1630712181,2070,1,429175
298,1574591910.191371,192.168.1.4,192.168.1.5,3791847022,3080504253,2070,1,431245
299,1574591910.202479,192.168.1.4,192.168.1.5,1726321187,2771426182,169,1,431414
300,1574591910.202917,192.168.1.5,192.168.1.4,2771426182,1726321356,73,0,431341
301,1574591910.234304,192.168.1.4,192.168.1.5,3791849092,3080504253,2381,1,433722
302,1574591910.234358,192.168.1.4,192.168.1.5,2006510105,1630712181,3379,1,437101
303,1574591910.247419,192.168.1.5,192.168.1.4,1630712181,2006513484,148,0,436953
304,1574591910.248062,192.168.1.5,192.168.1.4,1630712329,2006513484,115,0,436838
305,1574591910.249601,192.168.1.5,192.168.1.4,1630712444,2006513484,276,0,436562
306,1574591910.251446,192.168.1.5,192.168.1.4,3080504253,3791851473,148,0,436414
307,1574591910.267955,192.168.1.4,192.168.1.5,2006513484,1630712720,342,1,436756
308,1574591910.268295,192.168.1.5,192.168.1.4,1630712720,2006513826,60,0,436696
309,1574591910.273356,192.168.1.4,192.168.1.5,2006513826,1630712780,2070,1,438766
310,1574591910.275053,192.168.1.4,192.168.1.5,3600576798,2793707230,91,1,438857
311,1574591910.275339,192.168.1.4,192.168.1.5,1329516319,1758337118,91,1,438948
312,1574591910.275504,192.168.1.4,192.168.1.5,2394396180,1076946907,91,1,439039
313,1574591910.275832,192.168.1.5,192.168.1.4,2793707230,3600576889,539,0,438500
314,1574591910.276414,192.168.1.5,192.168.1.4,1076946907,2394396271,539,0,437961
315,1574591910.27653,192.168.1.5,192.168.1.4,1758337118,1329516410,539,0,437422
316,1574591910.282539,192.168.1.4,192.168.1.5,3791851473,3080504401,296,1,437718
317,1574591910.315184,192.168.1.4,192.168.1.5,2006515896,1630712780,6391,1,444109
318,1574591910.338417,192.168.1.4,192.168.1.5,3600576889,2793707769,2070,1,446179
319,1574591910.338683,192.168.1.4,192.168.1.5,1329516410,1758337657,2070,1,448249
320,1574591910.338848,192.168.1.4,192.168.1.5,2394396271,1076947446,2070,1,450319
321,1574591910.372488,192.168.1.5,192.168.1.4,2548271262,3257082363,343,0,449976
322,1574591910.373048,192.168.1.4,192.168.1.5,3257082363,2548271605,99,1,450075
323,1574591910.373417,192.168.1.5,192.168.1.4,2548271605,3257082462,382,0,449693
324,1574591910.380207,192.168.1.5,192.168.1.4,285640392,1668412541,343,0,449350
325,1574591910.382459,192.168.1.4,192.168.1.5,2394398341,1076947446,4306,1,453656
326,1574591910.382509,192.168.1.4,192.168.1.5,1329518480,1758337657,3130,1,456786
327,1574591910.382767,192.168.1.4,192.168.1.5,3600578959,2793707769,835,1,457621
328,1574591910.386453,192.168.1.4,192.168.1.5,1668412541,285640735,99,1,457720
329,1574591910.386834,192.168.1.5,192.168.1.4,285640735,1668412640,382,0,457338
330,1574591910.393595,192.168.1.4,192.168.1.5,3257082462,2548271987,2266,1,459604
331,1574591910.394814,192.168.1.5,192.168.1.4,2548271987,3257084728,74,0,459530
332,1574591910.394973,192.168.1.5,192.168.1.4,2548272061,3257084728,253,0,459277
333,1574591910.39834,192.168.1.4,192.168.1.5,3257084728,2548272314,79,1,459356
334,1574591910.398577,192.168.1.4,192.168.1.5,3257084807,2548272314,79,1,459435
335,1574591910.4074,192.168.1.4,192.168.1.5,1668412640,285641117,2266,1,461701
336,1574591910.408288,192.168.1.5,192.168.1.4,285641117,1668414906,74,0,461627
337,1574591910.408417,192.168.1.5,192.168.1.4,285641191,1668414906,225,0,461402
338,1574591910.408788,192.168.1.4,192.168.1.5,1668414906,285641416,79,1,461481
339,1574591910.415627,192.168.1.5,192.168.1.4,1758337657,1329521610,148,0,461333
340,1574591910.415794,192.168.1.4,192.168.1.5,1668414985,285641416,79,1,461412
341,1574591910.443776,192.168.1.4,192.168.1.5,1329521610,1758337805,73,1,461485
342,1574591910.45352,192.168.1.4,192.168.1.5,3250082893,3153702939,91,1,461576
343,1574591910.453546,192.168.1.4,192.168.1.5,4190170659,1279479902,91,1,461667
344,1574591910.471301,192.168.1.5,192.168.1.4,3153702939,3250082984,539,0,461128
345,1574591910.476174,192.168.1.5,192.168.1.4,1279479902,4190170750,539,0,460589
346,1574591910.495213,192.168.1.5,192.168.1.4,1076947446,2394402647,148,0,460441
347,1574591910.510478,192.168.1.5,192.168.1.4,3612498107,2180237771,343,0,460098
348,1574591910.510775,192.168.1.4,192.168.1.5,2180237771,3612498450,99,1,460197
349,1574591910.511204,192.168.1.5,192.168.1.4,3612498450,2180237870,382,0,459815
350,1574591910.513493,192.168.1.4,192.168.1.5,3250082984,3153703478,2070,1,461885
351,1574591910.515192,192.168.1.5,192.168.1.4,1493635524,2828653660,343,0,461542
352,1574591910.516182,192.168.1.4,192.168.1.5,4190170750,1279480441,2070,1,463612
353,1574591910.516266,192.168.1.4,192.168.1.5,2394402647,1076947594,333,1,463945
354,1574591910.517262,192.168.1.5,192.168.1.4,570820706,376820479,343,0,463602
355,1574591910.518829,192.168.1.4,192.168.1.5,2828653660,1493635867,99,1,463701
356,1574591910.519121,192.168.1.5,192.168.1.4,1493635867,2828653759,382,0,463319
357,1574591910.519355,192.168.1.5,192.168.1.4,4038306454,930522607,343,0,462976
358,1574591910.520941,192.168.1.5,192.168.1.4,2313421707,2004871030,343,0,462633
359,1574591910.52242,192.168.1.5,192.168.1.4,1734975332,2590570658,343,0,462290
360,1574591910.522857,192.168.1.4,192.168.1.5,376820479,570821049,99,1,462389
361,1574591910.523091,192.168.1.5,192.168.1.4,570821049,376820578,382,0,462007
362,1574591910.523467,192.168.1.4,192.168.1.5,930522607,4038306797,99,1,462106
363,1574591910.523764,192.168.1.5,192.168.1.4,4038306797,930522706,382,0,461724
364,1574591910.534976,192.168.1.5,192.168.1.4,1272083663,234088181,491,0,461233
365,1574591910.536266,192.168.1.4,192.168.1.5,2004871030,2313422050,99,1,461332
366,1574591910.536605,192.168.1.5,192.168.1.4,2313422050,2004871129,382,0,460950
367,1574591910.536899,192.168.1.4,192.168.1.5,2590570658,1734975675,99,1,461049
368,1574591910.537154,192.168.1.5,192.168.1.4,1734975675,2590570757,382,0,460667
369,1574591910.541203,192.168.1.4,192.168.1.5,4017393799,2214390182,91,1,460758
370,1574591910.543914,192.168.1.5,192.168.1.4,2214390182,4017393890,539,0,460219
371,1574591910.554158,192.168.1.5,192.168.1.4,2793707769,3600579794,148,0,460071
372,1574591910.554812,192.168.1.4,192.168.1.5,3250085054,3153703478,2865,1,462936
373,1574591910.556929,192.168.1.5,192.168.1.4,3153703478,3250087919,148,0,462788
374,1574591910.558388,192.168.1.4,192.168.1.5,4190172820,1279480441,1157,1,463945
375,1574591910.561032,192.168.1.4,192.168.1.5,2180237870,3612498832,2266,1,466211
376,1574591910.561867,192.168.1.5,192.168.1.4,3612498832,2180240136,74,0,466137
377,1574591910.562014,192.168.1.5,192.168.1.4,3612498906,2180240136,223,0,465914
378,1574591910.571469,192.168.1.4,192.168.1.5,234088181,1272084154,1470,1,467384
379,1574591910.574442,192.168.1.4,192.168.1.5,234089651,1272084154,707,1,468091
380,1574591910.575842,192.168.1.4,192.168.1.5,2180240136,3612499129,79,1,468170
381,1574591910.575994,192.168.1.4,192.168.1.5,2180240215,3612499129,79,1,468249
382,1574591910.579889,192.168.1.4,192.168.1.5,2828653759,1493636249,2266,1,470515
383,1574591910.580909,192.168.1.5,192.168.1.4,1493636249,2828656025,74,0,470441
384,1574591910.581149,192.168.1.4,192.168.1.5,376820578,570821431,2266,1,472707
385,1574591910.581349,192.168.1.4,192.168.1.5,2828656025,1493636323,79,1,472786
386,1574591910.581421,192.168.1.4,192.168.1.5,2828656104,1493636323,79,1,472865
387,1574591910.582583,192.168.1.5,192.168.1.4,570821431,376822844,74,0,472791
388,1574591910.582924,192.168.1.5,192.168.1.4,570821505,376822844,223,0,472568
389,1574591910.583361,192.168.1.4,192.168.1.5,4017393890,2214390721,2070,1,474638
390,1574591910.583632,192.168.1.4,192.168.1.5,376822844,570821728,79,1,474717
391,1574591910.583725,192.168.1.4,192.168.1.5,376822923,570821728,79,1,474796
392,1574591910.583795,192.168.1.5,192.168.1.4,1493636323,2828656183,223,0,474573
393,1574591910.585475,192.168.1.4,192.168.1.5,930522706,4038307179,2266,1,476839
394,1574591910.586781,192.168.1.5,192.168.1.4,4038307179,930524972,74,0,476765
395,1574591910.587021,192.168.1.5,192.168.1.4,4038307253,930524972,223,0,476542
396,1574591910.587243,192.168.1.4,192.168.1.5,2004871129,2313422432,2266,1,478808
397,1574591910.587631,192.168.1.4,192.168.1.5,2590570757,1734976057,2266,1,481074
398,1574591910.587811,192.168.1.4,192.168.1.5,930524972,4038307476,79,1,481153
399,1574591910.587888,192.168.1.4,192.168.1.5,930525051,4038307476,79,1,481232
400,1574591910.589498,192.168.1.4,192.168.1.5,3600579794,2793707917,280,1,481512
401,1574591910.591352,192.168.1.5,192.168.1.4,1279480441,4190173977,148,0,481364
402,1574591910.592932,192.168.1.5,192.168.1.4,2313422432,2004873395,74,0,481290
403,1574591910.593109,192.168.1.5,192.168.1.4,2313422506,2004873395,223,0,481067
404,1574591910.593484,192.168.1.4,192.168.1.5,2004873395,2313422729,79,1,481146
405,1574591910.593558,192.168.1.4,192.168.1.5,2004873474,2313422729,79,1,481225
406,1574591910.594293,192.168.1.4,192.168.1.5,3250087919,3153703626,280,1,481505
407,1574591910.597175,192.168.1.5,192.168.1.4,1734976057,2590573023,74,0,481431
408,1574591910.59742,192.168.1.5,192.168.1.4,1734976131,2590573023,225,0,481206
409,1574591910.59766,192.168.1.4,192.168.1.5,2590573023,1734976356,79,1,481285
410,1574591910.597784,192.168.1.4,192.168.1.5,2590573102,1734976356,79,1,481364
411,1574591910.610357,192.168.1.5,192.168.1.4,3282505471,70649083,343,0,481021
412,1574591910.610712,192.168.1.4,192.168.1.5,70649083,3282505814,99,1,481120
413,1574591910.61114,192.168.1.5,192.168.1.4,3282505814,70649182,382,0,480738
414,1574591910.620808,192.168.1.4,192.168.1.5,70649182,3282506196,2266,1,483004
415,1574591910.62184,192.168.1.5,192.168.1.4,3282506196,70651448,74,0,482930
416,1574591910.622168,192.168.1.4,192.168.1.5,70651448,3282506270,79,1,483009
417,1574591910.622231,192.168.1.4,192.168.1.5,70651527,3282506270,79,1,483088
418,1574591910.622833,192.168.1.5,192.168.1.4,3282506270,70651606,225,0,482863
419,1574591910.626114,192.168.1.4,192.168.1.5,4017395960,2214390721,808,1,483671
420,1574591910.631549,192.168.1.4,192.168.1.5,150903545,2588137242,91,1,483762
421,1574591910.631996,192.168.1.4,192.168.1.5,4190173977,1279480589,73,1,483835
422,1574591910.632943,192.168.1.5,192.168.1.4,2214390721,4017396768,86,0,483749
423,1574591910.633871,192.168.1.5,192.168.1.4,2588137242,150903636,539,0,483210
424,1574591910.647866,192.168.1.5,192.168.1.4,2214390807,4017396768,108,0,483102
425,1574591910.648873,192.168.1.5,192.168.1.4,2214390915,4017396768,269,0,482833
426,1574591910.649566,192.168.1.5,192.168.1.4,1279480589,4190174050,460,0,482373
427,1574591910.667564,192.168.1.4,192.168.1.5,4017396768,2214391184,586,1,482959
428,1574591910.667864,192.168.1.5,192.168.1.4,2214391184,4017397354,53,0,482906
429,1574591910.67478,192.168.1.4,192.168.1.5,150903636,2588137781,169,1,483075
430,1574591910.675278,192.168.1.5,192.168.1.4,2588137781,150903805,73,0,483002
431,1574591910.6829,192.168.1.4,192.168.1.5,4017397354,2214391237,53,1,483055
432,1574591910.685238,192.168.1.4,192.168.1.5,4190174050,1279481049,2070,1,485125
433,1574591910.688485,192.168.1.4,192.168.1.5,4125540840,2030260276,91,1,485216
434,1574591910.697756,192.168.1.5,192.168.1.4,2030260276,4125540931,539,0,484677
435,1574591910.726382,192.168.1.4,192.168.1.5,4190176120,1279481049,2864,1,487541
436,1574591910.726456,192.168.1.4,192.168.1.5,4017397407,2214391237,13032,1,500573
437,1574591910.726603,192.168.1.4,192.168.1.5,4017410439,2214391237,4258,1,504831
438,1574591910.733474,192.168.1.4,192.168.1.5,4125540931,2030260815,2070,1,506901
439,1574591910.746931,192.168.1.5,192.168.1.4,2214391237,4017414697,61,0,506840
440,1574591910.748597,192.168.1.5,192.168.1.4,1272084154,234090358,478,0,506362
441,1574591910.749665,192.168.1.5,192.168.1.4,1279481049,4190178984,485,0,505877
442,1574591910.752739,192.168.1.5,192.168.1.4,1481809055,4102886679,468,0,505409
443,1574591910.774626,192.168.1.4,192.168.1.5,4125543001,2030260815,2733,1,508142
444,1574591910.782034,192.168.1.5,192.168.1.4,2030260815,4125545734,148,0,507994
445,1574591910.784868,192.168.1.4,192.168.1.5,234090358,1272084632,1010,1,509004
446,1574591910.785865,192.168.1.4,192.168.1.5,4190178984,1279481534,2070,1,511074
447,1574591910.794597,192.168.1.4,192.168.1.5,4102886679,1481809523,585,1,511659
448,1574591910.809094,192.168.1.5,192.168.1.4,1272084632,234091368,589,0,511070
449,1574591910.810494,192.168.1.5,192.168.1.4,1481809523,4102887264,586,0,510484
450,1574591910.816736,192.168.1.4,192.168.1.5,4125545734,2030260963,73,1,510557
451,1574591910.822462,192.168.1.4,192.168.1.5,4190181054,1279481534,13032,1,523589
452,1574591910.822638,192.168.1.4,192.168.1.5,4190194086,1279481534,1448,1,525037
453,1574591910.822812,192.168.1.4,192.168.1.5,4190195534,1279481534,11584,1,536621
454,1574591910.822953,192.168.1.4,192.168.1.5,4190207118,1279481534,8783,1,545404
455,1574591910.848187,192.168.1.4,192.168.1.5,234091368,1272085221,746,1,546150
456,1574591910.850267,192.168.1.4,192.168.1.5,4102887264,1481810109,713,1,546863
457,1574591910.859301,192.168.1.4,192.168.1.5,4190215901,1279481534,14480,1,561343
458,1574591910.859447,192.168.1.4,192.168.1.5,4190230381,1279481534,1926,1,563269
459,1574591910.859491,192.168.1.4,192.168.1.5,4190232307,1279481534,15928,1,579197
460,1574591910.859584,192.168.1.4,192.168.1.5,4190248235,1279481534,478,1,579675
461,1574591910.859591,192.168.1.4,192.168.1.5,4190248713,1279481534,414,1,580089
462,1574591910.869198,192.168.1.5,192.168.1.4,1481810109,4102887977,586,0,579503
463,1574591910.894155,192.168.1.5,192.168.1.4,1272085221,234092114,504,0,578999
464,1574591910.902337,192.168.1.4,192.168.1.5,4190249127,1279481534,16406,1,595405
465,1574591910.902396,192.168.1.4,192.168.1.5,4190265533,1279481534,3454,1,598859
466,1574591910.907868,192.168.1.4,192.168.1.5,4102887977,1481810695,655,1,599514
467,1574591910.945153,192.168.1.4,192.168.1.5,3755083164,3406482793,91,1,599605
468,1574591910.946158,192.168.1.5,192.168.1.4,3406482793,3755083255,539,0,599066
469,1574591910.95632,192.168.1.4,192.168.1.5,234092114,1272085725,585,1,599651
470,1574591910.969507,192.168.1.5,192.168.1.4,4022800966,1531475132,343,0,599308
471,1574591910.969961,192.168.1.4,192.168.1.5,1531475132,4022801309,99,1,599407
472,1574591910.970427,192.168.1.4,192.168.1.5,4190268987,1279481534,1441,1,600848
473,1574591910.970599,192.168.1.5,192.168.1.4,4022801309,1531475231,382,0,600466
474,1574591910.978274,192.168.1.5,192.168.1.4,1279481534,4190270428,517,0,599949
475,1574591910.984567,192.168.1.4,192.168.1.5,3755083255,3406483332,2070,1,602019
476,1574591910.986794,192.168.1.4,192.168.1.5,1531475231,4022801691,2266,1,604285
477,1574591910.987626,192.168.1.5,192.168.1.4,4022801691,1531477497,74,0,604211
478,1574591910.987758,192.168.1.5,192.168.1.4,4022801765,1531477497,241,0,603970
479,1574591910.987994,192.168.1.4,192.168.1.5,1531477497,4022802006,79,1,604049
480,1574591910.988084,192.168.1.4,192.168.1.5,1531477576,4022802006,79,1,604128
481,1574591911.026429,192.168.1.4,192.168.1.5,3755085325,3406483332,1756,1,605884
482,1574591911.036868,192.168.1.5,192.168.1.4,3406483332,3755087081,86,0,605798
483,1574591911.037207,192.168.1.5,192.168.1.4,3406483418,3755087081,108,0,605690
484,1574591911.037612,192.168.1.5,192.168.1.4,3406483526,3755087081,279,0,605411
485,1574591911.043847,192.168.1.4,192.168.1.5,4190270428,1279482051,2070,1,607481
486,1574591911.045961,192.168.1.4,192.168.1.5,4190272498,1279482051,16406,1,623887
487,1574591911.04614,192.168.1.4,192.168.1.5,4190288904,1279482051,16406,1,640293
488,1574591911.046187,192.168.1.4,192.168.1.5,4190305310,1279482051,5779,1,646072
489,1574591911.080851,192.168.1.4,192.168.1.5,3755087081,3406483805,2070,1,648142
490,1574591911.086254,192.168.1.4,192.168.1.5,4190311089,1279482051,10158,1,658300
491,1574591911.087453,192.168.1.5,192.168.1.4,3406483805,3755089151,53,0,658247
492,1574591911.087883,192.168.1.4,192.168.1.5,3755089151,3406483858,1405,1,659652
493,1574591911.088574,192.168.1.5,192.168.1.4,3406483858,3755090556,61,0,659591
494,1574591911.118096,192.168.1.4,192.168.1.5,4190321247,1279482051,1370,1,660961
495,1574591911.118743,192.168.1.5,192.168.1.4,1279482051,4190322617,504,0,660457
496,1574591911.160259,192.168.1.5,192.168.1.4,1758337805,1329521683,472,0,659985
497,1574591911.161601,192.168.1.4,192.168.1.5,4190322617,1279482555,2070,1,662055
498,1574591911.162966,192.168.1.4,192.168.1.5,4190324687,1279482555,16406,1,678461
499,1574591911.163253,192.168.1.4,192.168.1.5,4190341093,1279482555,16406,1,694867
500,1574591911.163297,192.168.1.4,192.168.1.5,4190357499,1279482555,4419,1,699286
501,1574591911.177853,192.168.1.5,192.168.1.4,1630712780,2006522287,98,0,699188
502,1574591911.188877,192.168.1.5,192.168.1.4,1600950442,1085850206,343,0,698845
503,1574591911.189344,192.168.1.4,192.168.1.5,1085850206,1600950785,99,1,698944
504,1574591911.189752,192.168.1.5,192.168.1.4,1600950785,1085850305,382,0,698562
505,1574591911.191303,192.168.1.4,192.168.1.5,1329521683,1758338277,8688,1,707250
506,1574591911.191479,192.168.1.4,192.168.1.5,1329530371,1758338277,5792,1,713042
507,1574591911.191511,192.168.1.4,192.168.1.5,1329536163,1758338277,22,1,713064
508,1574591911.195218,192.168.1.5,192.168.1.4,2940305360,3417767222,343,0,712721
509,1574591911.198791,192.168.1.4,192.168.1.5,3417767222,2940305703,99,1,712820
510,1574591911.199159,192.168.1.5,192.168.1.4,2940305703,3417767321,382,0,712438
511,1574591911.202542,192.168.1.4,192.168.1.5,2006522287,1630712878,5814,1,718252
512,1574591911.204609,192.168.1.4,192.168.1.5,2006528101,1630712878,2918,1,721170
513,1574591911.206211,192.168.1.4,192.168.1.5,4190361918,1279482555,453,1,721623
514,1574591911.211408,192.168.1.4,192.168.1.5,2006531019,1630712878,11606,1,733229
515,1574591911.213281,192.168.1.4,192.168.1.5,2006542625,1630712878,3501,1,736730
516,1574591911.219419,192.168.1.4,192.168.1.5,1329536185,1758338277,5814,1,742544
517,1574591911.220536,192.168.1.4,192.168.1.5,1329541999,1758338277,2070,1,744614
518,1574591911.222473,192.168.1.4,192.168.1.5,1085850305,1600951167,2266,1,746880
519,1574591911.223796,192.168.1.5,192.168.1.4,1600951167,1085852571,74,0,746806
520,1574591911.223985,192.168.1.5,192.168.1.4,1600951241,1085852571,231,0,746575
521,1574591911.224337,192.168.1.4,192.168.1.5,1085852571,1600951472,79,1,746654
522,1574591911.227396,192.168.1.4,192.168.1.5,1085852650,1600951472,79,1,746733
523,1574591911.22869,192.168.1.4,192.168.1.5,3417767321,2940306085,2266,1,748999
524,1574591911.229562,192.168.1.5,192.168.1.4,2940306085,3417769587,74,0,748925
525,1574591911.229749,192.168.1.5,192.168.1.4,2940306159,3417769587,231,0,748694
526,1574591911.230109,192.168.1.4,192.168.1.5,3417769587,2940306390,79,1,748773
527,1574591911.230207,192.168.1.4,192.168.1.5,3417769666,2940306390,79,1,748852
528,1574591911.244761,192.168.1.5,192.168.1.4,1272085725,234092699,446,0,748406
529,1574591911.247876,192.168.1.5,192.168.1.4,1481810695,4102888632,446,0,747960
530,1574591911.262346,192.168.1.4,192.168.1.5,1329544069,1758338277,16406,1,764366
531,1574591911.262409,192.168.1.4,192.168.1.5,1329560475,1758338277,1983,1,766349
532,1574591911.27868,192.168.1.4,192.168.1.5,234092699,1272086171,1008,1,767357
533,1574591911.285317,192.168.1.4,192.168.1.5,4102888632,1481811141,1006,1,768363
534,1574591911.380968,192.168.1.5,192.168.1.4,3153703626,3250088199,630,0,767733
535,1574591911.424626,192.168.1.4,192.168.1.5,3250088199,3153704256,1142,1,768875
536,1574591911.591068,192.168.1.5,192.168.1.4,1279482555,4190362371,24,0,768851
537,1574591911.591543,192.168.1.4,192.168.1.5,4190362371,1279482579,24,1,768875
538,1574591911.594838,192.168.1.5,192.168.1.4,457410123,2885032959,343,0,768532
539,1574591911.595161,192.168.1.4,192.168.1.5,2885032959,457410466,99,1,768631
540,1574591911.595644,192.168.1.5,192.168.1.4,457410466,2885033058,382,0,768249
541,1574591911.604997,192.168.1.4,192.168.1.5,2885033058,457410848,2266,1,770515
542,1574591911.606041,192.168.1.5,192.168.1.4,457410848,2885035324,74,0,770441
543,1574591911.606232,192.168.1.5,192.168.1.4,457410922,2885035324,235,0,770206
544,1574591911.60657,192.168.1.4,192.168.1.5,2885035324,457411157,79,1,770285
545,1574591911.60671,192.168.1.4,192.168.1.5,2885035403,457411157,79,1,770364
546,1574591911.610282,192.168.1.5,192.168.1.4,1481811141,4102889638,589,0,769775
547,1574591911.645894,192.168.1.4,192.168.1.5,4102889638,1481811730,666,1,770441
548,1574591911.647799,192.168.1.5,192.168.1.4,1481811730,4102890304,591,0,769850
549,1574591911.684963,192.168.1.4,192.168.1.5,4102890304,1481812321,1629,1,771479
550,1574591911.686304,192.168.1.5,192.168.1.4,1481812321,4102891933,577,0,770902
551,1574591911.725333,192.168.1.4,192.168.1.5,4102891933,1481812898,1741,1,772643
552,1574591911.727164,192.168.1.5,192.168.1.4,1481812898,4102893674,581,0,772062
553,1574591911.735258,192.168.1.4,192.168.1.5,3257084886,2548272314,91,1,772153
554,1574591911.73582,192.168.1.5,192.168.1.4,2548272314,3257084977,539,0,771614
555,1574591911.774933,192.168.1.4,192.168.1.5,3257084977,2548272853,121,1,771735
556,1574591911.774966,192.168.1.4,192.168.1.5,4102893674,1481813479,2053,1,773788
557,1574591911.779134,192.168.1.5,192.168.1.4,2548272853,3257085098,545,0,773243
558,1574591911.785649,192.168.1.5,192.168.1.4,1481813479,4102895727,582,0,772661
559,1574591911.810056,192.168.1.4,192.168.1.5,3257085098,2548273398,2070,1,774731
560,1574591911.82255,192.168.1.4,192.168.1.5,4102895727,1481814061,1470,1,776201
561,1574591911.835649,192.168.1.5,192.168.1.4,3153704256,3250089341,701,0,775500
562,1574591911.850543,192.168.1.4,192.168.1.5,3257087168,2548273398,3067,1,778567
563,1574591911.853815,192.168.1.5,192.168.1.4,2548273398,3257090235,96,0,778471
564,1574591911.85419,192.168.1.5,192.168.1.4,2548273494,3257090235,108,0,778363
565,1574591911.856354,192.168.1.5,192.168.1.4,2548273602,3257090235,364,0,777999
566,1574591911.86635,192.168.1.4,192.168.1.5,4102897197,1481814061,722,1,778721
567,1574591911.869266,192.168.1.5,192.168.1.4,1481814061,4102897919,579,0,778142
568,1574591911.876243,192.168.1.4,192.168.1.5,3250089341,3153704957,745,1,778887
569,1574591911.88541,192.168.1.4,192.168.1.5,3257090235,2548273966,691,1,779578
570,1574591911.88723,192.168.1.5,192.168.1.4,2548273966,3257090926,53,0,779525
571,1574591911.888231,192.168.1.5,192.168.1.4,1272086171,234093707,580,0,778945
572,1574591911.890366,192.168.1.4,192.168.1.5,3257090926,2548274019,2070,1,781015
573,1574591911.891889,192.168.1.4,192.168.1.5,3257092996,2548274019,14480,1,795495
574,1574591911.892173,192.168.1.4,192.168.1.5,3257107476,2548274019,15928,1,811423
575,1574591911.89227,192.168.1.4,192.168.1.5,3257123404,2548274019,5998,1,817421
576,1574591911.908034,192.168.1.4,192.168.1.5,4102897919,1481814640,1771,1,819192
577,1574591911.925323,192.168.1.4,192.168.1.5,234093707,1272086751,940,1,820132
578,1574591911.937348,192.168.1.4,192.168.1.5,3257129402,2548274019,15346,1,835478
579,1574591911.969397,192.168.1.5,192.168.1.4,1272086751,234094647,575,0,834903
580,1574591911.970334,192.168.1.5,192.168.1.4,1481814640,4102899690,582,0,834321
581,1574591912.0071,192.168.1.4,192.168.1.5,234094647,1272087326,912,1,835233
582,1574591912.007159,192.168.1.4,192.168.1.5,4102899690,1481815222,1070,1,836303
583,1574591912.017216,192.168.1.5,192.168.1.4,1481815222,4102900760,587,0,835716
584,1574591912.018759,192.168.1.5,192.168.1.4,1272087326,234095559,577,0,835139
585,1574591912.05309,192.168.1.4,192.168.1.5,234095559,1272087903,1172,1,836311
586,1574591912.055617,192.168.1.4,192.168.1.5,4102900760,1481815809,1627,1,837938
587,1574591912.064793,192.168.1.5,192.168.1.4,1481815809,4102902387,579,0,837359
588,1574591912.079917,192.168.1.5,192.168.1.4,1272087903,234096731,578,0,836781
589,1574591912.100874,192.168.1.4,192.168.1.5,4102902387,1481816388,1744,1,838525
590,1574591912.113864,192.168.1.5,192.168.1.4,1481816388,4102904131,582,0,837943
591,1574591912.115081,192.168.1.4,192.168.1.5,234096731,1272088481,2051,1,839994
592,1574591912.131617,192.168.1.5,192.168.1.4,1272088481,234098782,581,0,839413
593,1574591912.149835,192.168.1.4,192.168.1.5,4102904131,1481816970,2070,1,841483
594,1574591912.155867,192.168.1.5,192.168.1.4,2388783245,1033080637,24,0,841459
595,1574591912.156444,192.168.1.4,192.168.1.5,1033080637,2388783270,24,1,841483
596,1574591912.158011,192.168.1.5,192.168.1.4,3345434006,991938424,343,0,841140
597,1574591912.158353,192.168.1.4,192.168.1.5,991938424,3345434349,99,1,841239
598,1574591912.158785,192.168.1.5,192.168.1.4,3345434349,991938523,382,0,840857
599,1574591912.161108,192.168.1.5,192.168.1.4,3080504401,3791851769,24,0,840833
600,1574591912.161644,192.168.1.4,192.168.1.5,3791851769,3080504426,24,1,840857
601,1574591912.165576,192.168.1.5,192.168.1.4,2764855858,3179556539,343,0,840514
602,1574591912.16761,192.168.1.4,192.168.1.5,234098782,1272089062,2070,1,842584
603,1574591912.170412,192.168.1.4,192.168.1.5,3179556539,2764856201,99,1,842683
604,1574591912.170887,192.168.1.5,192.168.1.4,2764856201,3179556638,382,0,842301
605,1574591912.174839,192.168.1.4,192.168.1.5,991938523,3345434731,2266,1,844567
606,1574591912.175832,192.168.1.5,192.168.1.4,3345434731,991940789,74,0,844493
607,1574591912.175952,192.168.1.5,192.168.1.4,3345434805,991940789,245,0,844248
608,1574591912.17611,192.168.1.4,192.168.1.5,991940789,3345435050,79,1,844327
609,1574591912.176174,192.168.1.4,192.168.1.5,991940868,3345435050,79,1,844406
610,1574591912.182813,192.168.1.4,192.168.1.5,3179556638,2764856583,2266,1,846672
611,1574591912.183822,192.168.1.5,192.168.1.4,2764856583,3179558904,74,0,846598
612,1574591912.183945,192.168.1.5,192.168.1.4,2764856657,3179558904,247,0,846351
613,1574591912.184201,192.168.1.4,192.168.1.5,3179558904,2764856904,79,1,846430
614,1574591912.184271,192.168.1.4,192.168.1.5,3179558983,2764856904,79,1,846509
615,1574591912.190318,192.168.1.4,192.168.1.5,4102906201,1481816970,2804,1,849313
616,1574591912.197211,192.168.1.5,192.168.1.4,1076947594,2394402980,115,0,849198
617,1574591912.201497,192.168.1.5,192.168.1.4,1076947709,2394402980,60,0,849138
618,1574591912.201719,192.168.1.5,192.168.1.4,1076947769,2394402980,380,0,848758
619,1574591912.210379,192.168.1.4,192.168.1.5,234100852,1272089062,281,1,849039
620,1574591912.217609,192.168.1.4,192.168.1.5,2394402980,1076948149,60,1,849099
621,1574591912.223038,192.168.1.5,192.168.1.4,3127880213,2494162980,108,0,848991
622,1574591912.225146,192.168.1.5,192.168.1.4,1076948149,2394403040,188,0,848803
623,1574591912.227489,192.168.1.5,192.168.1.4,1076948337,2394403040,188,0,848615
624,1574591912.227705,192.168.1.5,192.168.1.4,1076948525,2394403040,167,0,848448
625,1574591912.227957,192.168.1.5,192.168.1.4,1076948692,2394403040,180,0,848268
626,1574591912.228119,192.168.1.5,192.168.1.4,3127880321,2494162980,53,0,848215
627,1574591912.228306,192.168.1.5,192.168.1.4,3127880374,2494162980,282,0,847933
628,1574591912.231481,192.168.1.4,192.168.1.5,2394403040,1076948872,2070,1,850003
629,1574591912.243499,192.168.1.4,192.168.1.5,2394405110,1076948872,14480,1,864483
630,1574591912.243894,192.168.1.4,192.168.1.5,2394419590,1076948872,17376,1,881859
631,1574591912.244121,192.168.1.4,192.168.1.5,2394436966,1076948872,956,1,882815
632,1574591912.244854,192.168.1.4,192.168.1.5,2394437922,1076948872,2854,1,885669
633,1574591912.256212,192.168.1.4,192.168.1.5,2494162980,3127880656,53,1,885722
634,1574591912.25905,192.168.1.4,192.168.1.5,2394440776,1076948872,16406,1,902128
635,1574591912.25935,192.168.1.4,192.168.1.5,2394457182,1076948872,16406,1,918534
636,1574591912.259394,192.168.1.4,192.168.1.5,2394473588,1076948872,1510,1,920044
637,1574591912.272411,192.168.1.4,192.168.1.5,2394475098,1076948872,16406,1,936450
638,1574591912.27254,192.168.1.4,192.168.1.5,2394491504,1076948872,16406,1,952856
639,1574591912.272579,192.168.1.4,192.168.1.5,2394507910,1076948872,414,1,953270
640,1574591912.275496,192.168.1.4,192.168.1.5,2494163033,3127880656,4344,1,957614
641,1574591912.276166,192.168.1.4,192.168.1.5,2494167377,3127880656,320,1,957934
642,1574591912.276208,192.168.1.4,192.168.1.5,2494167697,3127880656,2858,1,960792
643,1574591912.279498,192.168.1.4,192.168.1.5,2394508324,1076948872,16406,1,977198
644,1574591912.279611,192.168.1.4,192.168.1.5,2394524730,1076948872,16406,1,993604
645,1574591912.279649,192.168.1.4,192.168.1.5,2394541136,1076948872,1798,1,995402
646,1574591912.28132,192.168.1.4,192.168.1.5,2494170555,3127880656,2858,1,998260
647,1574591912.286297,192.168.1.4,192.168.1.5,2494173413,3127880656,2858,1,1001118
648,1574591912.288265,192.168.1.4,192.168.1.5,2494176271,3127880656,2858,1,1003976
649,1574591912.292434,192.168.1.4,192.168.1.5,2494179129,3127880656,2858,1,1006834
650,1574591912.29529,192.168.1.4,192.168.1.5,2494181987,3127880656,2858,1,1009692
651,1574591912.301056,192.168.1.4,192.168.1.5,2394542934,1076948872,16406,1,1026098
652,1574591912.301173,192.168.1.4,192.168.1.5,2394559340,1076948872,16406,1,1042504
653,1574591912.30121,192.168.1.4,192.168.1.5,2394575746,1076948872,310,1,1042814
654,1574591912.302268,192.168.1.4,192.168.1.5,2494184845,3127880656,2070,1,1044884
655,1574591912.324414,192.168.1.4,192.168.1.5,2494186915,3127880656,14480,1,1059364
656,1574591912.324736,192.168.1.4,192.168.1.5,2494201395,3127880656,20428,1,1079792
657,1574591912.325863,192.168.1.4,192.168.1.5,2494221823,3127880656,1440,1,1081232
658,1574591912.326579,192.168.1.4,192.168.1.5,2494223263,3127880656,1440,1,1082672
659,1574591912.34228,192.168.1.4,192.168.1.5,2394576056,1076948872,10064,1,1092736
660,1574591912.370304,192.168.1.4,192.168.1.5,2494224703,3127880656,467,1,1093203
661,1574591912.370905,192.168.1.5,192.168.1.4,3127880656,2494225170,61,0,1093142
662,1574591912.48779,192.168.1.5,192.168.1.4,3348896963,3738557951,24,0,1093118
663,1574591912.488288,192.168.1.4,192.168.1.5,3738557951,3348896988,24,1,1093142
664,1574591912.490854,192.168.1.5,192.168.1.4,4055226146,1663058591,343,0,1092799
665,1574591912.49132,192.168.1.4,192.168.1.5,1663058591,4055226489,99,1,1092898
666,1574591912.491611,192.168.1.5,192.168.1.4,4055226489,1663058690,382,0,1092516
667,1574591912.501372,192.168.1.4,192.168.1.5,1663058690,4055226871,2266,1,1094782
668,1574591912.502292,192.168.1.5,192.168.1.4,4055226871,1663060956,74,0,1094708
669,1574591912.50241,192.168.1.5,192.168.1.4,4055226945,1663060956,243,0,1094465
670,1574591912.502705,192.168.1.4,192.168.1.5,1663060956,4055226945,79,1,1094544
671,1574591912.502809,192.168.1.4,192.168.1.5,1663061035,4055227188,79,1,1094623
672,1574591912.530005,192.168.1.5,192.168.1.4,3153704957,3250090086,24,0,1094599
673,1574591912.530582,192.168.1.4,192.168.1.5,3250090086,3153704981,24,1,1094623
674,1574591912.532266,192.168.1.5,192.168.1.4,3591137199,1273633200,343,0,1094280
675,1574591912.532652,192.168.1.4,192.168.1.5,1273633200,3591137542,99,1,1094379
676,1574591912.532938,192.168.1.5,192.168.1.4,3591137542,1273633299,382,0,1093997
677,1574591912.542638,192.168.1.4,192.168.1.5,1273633299,3591137924,2266,1,1096263
678,1574591912.54346,192.168.1.5,192.168.1.4,3591137924,1273635565,74,0,1096189
679,1574591912.543576,192.168.1.5,192.168.1.4,3591137998,1273635565,235,0,1095954
680,1574591912.543796,192.168.1.4,192.168.1.5,1273635565,3591137998,79,1,1096033
681,1574591912.543886,192.168.1.4,192.168.1.5,1273635644,3591138233,79,1,1096112
682,1574591912.825165,192.168.1.5,192.168.1.4,2793707917,3600580074,24,0,1096088
683,1574591912.825708,192.168.1.4,192.168.1.5,3600580074,2793707942,24,1,1096112
684,1574591912.827673,192.168.1.5,192.168.1.4,143587711,1502370736,343,0,1095769
685,1574591912.828062,192.168.1.4,192.168.1.5,1502370736,143588054,99,1,1095868
686,1574591912.828557,192.168.1.5,192.168.1.4,143588054,1502370835,382,0,1095486
687,1574591912.836712,192.168.1.5,192.168.1.4,2030260963,4125545807,24,0,1095462
688,1574591912.837201,192.168.1.4,192.168.1.5,4125545807,2030260987,24,1,1095486
689,1574591912.838998,192.168.1.5,192.168.1.4,936150483,3959879490,343,0,1095143
690,1574591912.840167,192.168.1.4,192.168.1.5,1502370835,143588436,2266,1,1097409
691,1574591912.840845,192.168.1.4,192.168.1.5,3959879490,936150826,99,1,1097508
692,1574591912.841281,192.168.1.5,192.168.1.4,143588436,1502373101,74,0,1097434
693,1574591912.841425,192.168.1.5,192.168.1.4,143588510,1502373101,247,0,1097187
694,1574591912.841682,192.168.1.4,192.168.1.5,1502373101,143588757,79,1,1097266
695,1574591912.842058,192.168.1.5,192.168.1.4,936150826,3959879589,382,0,1096884
696,1574591912.842125,192.168.1.4,192.168.1.5,1502373180,143588757,79,1,1096963
697,1574591912.852761,192.168.1.4,192.168.1.5,3959879589,936151208,2266,1,1099229
698,1574591912.85367,192.168.1.5,192.168.1.4,936151208,3959881855,74,0,1099155
699,1574591912.853796,192.168.1.5,192.168.1.4,936151282,3959881855,247,0,1098908
700,1574591912.854051,192.168.1.4,192.168.1.5,3959881855,936151529,79,1,1098987
701,1574591912.856339,192.168.1.4,192.168.1.5,3959881934,936151529,79,1,1099066
702,1574591912.96946,192.168.1.5,192.168.1.4,4022802006,1531477655,24,0,1099042
703,1574591913.287609,192.168.1.5,192.168.1.4,3374262578,1846811465,343,0,1098699
704,1574591913.28802,192.168.1.4,192.168.1.5,1846811465,3374262921,99,1,1098798
705,1574591913.288324,192.168.1.5,192.168.1.4,3374262921,1846811564,382,0,1098416
706,1574591913.297565,192.168.1.4,192.168.1.5,1846811564,3374263303,2266,1,1100682
707,1574591913.299695,192.168.1.5,192.168.1.4,3374263303,1846813830,74,0,1100608
708,1574591913.299829,192.168.1.5,192.168.1.4,3374263377,1846813830,239,0,1100369
709,1574591913.303013,192.168.1.4,192.168.1.5,1846813830,3374263616,79,1,1100448
710,1574591913.303043,192.168.1.4,192.168.1.5,1846813909,3374263616,79,1,1100527
711,1574591913.332818,192.168.1.5,192.168.1.4,1758338277,1329562458,24,0,1100503
712,1574591913.333314,192.168.1.4,192.168.1.5,1329562458,1758338301,24,1,1100527
713,1574591913.335758,192.168.1.5,192.168.1.4,719219489,3742763523,343,0,1100184
714,1574591913.33608,192.168.1.4,192.168.1.5,3742763523,719219832,99,1,1100283
715,1574591913.336534,192.168.1.5,192.168.1.4,719219832,3742763622,382,0,1099901
716,1574591913.339982,192.168.1.5,192.168.1.4,3487527285,2180118475,24,0,1099877
717,1574591913.34044,192.168.1.4,192.168.1.5,2180118475,3487527309,24,1,1099901
718,1574591913.34205,192.168.1.5,192.168.1.4,1191478298,3122167376,343,0,1099558
719,1574591913.344476,192.168.1.5,192.168.1.4,2815066720,502756940,24,0,1099534
720,1574591913.344976,192.168.1.4,192.168.1.5,502756940,2815066744,24,1,1099558
721,1574591913.345442,192.168.1.4,192.168.1.5,3122167376,1191478641,99,1,1099657
722,1574591913.345998,192.168.1.5,192.168.1.4,1191478641,3122167475,382,0,1099275
723,1574591913.3497,192.168.1.5,192.168.1.4,3570665166,1676006097,343,0,1098932
724,1574591913.351428,192.168.1.4,192.168.1.5,3742763622,719220214,2266,1,1101198
725,1574591913.351777,192.168.1.4,192.168.1.5,1676006097,3570665509,99,1,1101297
726,1574591913.35252,192.168.1.5,192.168.1.4,719220214,3742765888,74,0,1101223
727,1574591913.352648,192.168.1.5,192.168.1.4,719220288,3742765888,231,0,1100992
728,1574591913.353188,192.168.1.5,192.168.1.4,3570665509,1676006196,382,0,1100610
729,1574591913.354181,192.168.1.4,192.168.1.5,3742765888,719220519,79,1,1100689
730,1574591913.357016,192.168.1.4,192.168.1.5,3742765967,719220519,79,1,1100768
731,1574591913.367109,192.168.1.4,192.168.1.5,3122167475,1191479023,2266,1,1103034
732,1574591913.368269,192.168.1.5,192.168.1.4,1191479023,3122169741,74,0,1102960
733,1574591913.368439,192.168.1.5,192.168.1.4,1191479097,3122169741,251,0,1102709
734,1574591913.370241,192.168.1.4,192.168.1.5,1676006196,3570665891,2266,1,1104975
735,1574591913.370444,192.168.1.4,192.168.1.5,3122169741,1191479348,79,1,1105054
736,1574591913.370566,192.168.1.4,192.168.1.5,3122169820,1191479348,79,1,1105133
737,1574591913.371318,192.168.1.5,192.168.1.4,3570665891,1676008462,74,0,1105059
738,1574591913.37144,192.168.1.5,192.168.1.4,3570665965,1676008462,237,0,1104822
739,1574591913.371655,192.168.1.4,192.168.1.5,1676008462,3570665965,79,1,1104901
740,1574591913.371763,192.168.1.4,192.168.1.5,1676008541,3570666202,79,1,1104980
741,1574591913.769989,192.168.1.5,192.168.1.4,1550376807,33341586,24,0,1104956
742,1574591913.771039,192.168.1.4,192.168.1.5,33341586,1550376831,24,1,1104980
743,1574591913.774756,192.168.1.5,192.168.1.4,2929084134,385147313,343,0,1104637
744,1574591913.775555,192.168.1.4,192.168.1.5,385147313,2929084477,99,1,1104736
745,1574591913.776534,192.168.1.5,192.168.1.4,2929084477,385147412,382,0,1104354
746,1574591913.786772,192.168.1.4,192.168.1.5,385147412,2929084859,2266,1,1106620
747,1574591913.787763,192.168.1.5,192.168.1.4,2929084859,385149678,74,0,1106546
748,1574591913.787888,192.168.1.5,192.168.1.4,2929084933,385149678,247,0,1106299
749,1574591913.788164,192.168.1.4,192.168.1.5,385149678,2929085180,79,1,1106378
750,1574591913.788449,192.168.1.4,192.168.1.5,385149757,2929085180,79,1,1106457
751,1574591913.871223,192.168.1.5,192.168.1.4,3127880717,2494225170,1867,0,1104590
752,1574591913.913351,192.168.1.5,192.168.1.4,3127882584,2494225170,104,0,1104486
753,1574591913.925133,192.168.1.5,192.168.1.4,719220519,3742766046,24,0,1104462
754,1574591913.950896,192.168.1.4,192.168.1.5,2494225170,3127882688,2070,1,1106532
755,1574591913.994537,192.168.1.4,192.168.1.5,2494227240,3127882688,14480,1,1121012
756,1574591913.99499,192.168.1.4,192.168.1.5,2494241720,3127882688,9866,1,1130878
757,1574591914.002755,192.168.1.5,192.168.1.4,3127882688,2494251586,61,0,1130817
758,1574591914.3557,192.168.1.4,192.168.1.5,2494251586,3127882749,2070,1,1132887
759,1574591914.398476,192.168.1.4,192.168.1.5,2494253656,3127882749,14480,1,1147367
760,1574591914.398917,192.168.1.4,192.168.1.5,2494268136,3127882749,15306,1,1162673
761,1574591914.406542,192.168.1.5,192.168.1.4,3127882749,2494283442,61,0,1162612
762,1574591914.432442,192.168.1.5,192.168.1.4,248012345,1072606997,343,0,1162269
763,1574591914.433083,192.168.1.4,192.168.1.5,1072606997,248012688,99,1,1162368
764,1574591914.433339,192.168.1.5,192.168.1.4,248012688,1072607096,382,0,1161986
765,1574591914.448325,192.168.1.4,192.168.1.5,1072607096,248013070,2266,1,1164252
766,1574591914.449288,192.168.1.5,192.168.1.4,248013070,1072609362,74,0,1164178
767,1574591914.449485,192.168.1.5,192.168.1.4,248013144,1072609362,243,0,1163935
768,1574591914.449836,192.168.1.4,192.168.1.5,1072609362,248013387,79,1,1164014
769,1574591914.450008,192.168.1.4,192.168.1.5,1072609441,248013387,79,1,1164093
770,1574591914.48279,192.168.1.5,192.168.1.4,2771426255,1726321356,24,0,1164069
771,1574591914.483416,192.168.1.4,192.168.1.5,1726321356,2771426279,24,1,1164093
772,1574591914.48528,192.168.1.5,192.168.1.4,1960985471,1175774171,343,0,1163750
773,1574591914.485757,192.168.1.4,192.168.1.5,1175774171,1960985814,99,1,1163849
774,1574591914.486187,192.168.1.5,192.168.1.4,1960985814,1175774270,382,0,1163467
775,1574591914.500399,192.168.1.4,192.168.1.5,1175774270,1960986196,2266,1,1165733
776,1574591914.501439,192.168.1.5,192.168.1.4,1960986196,1175776536,74,0,1165659
777,1574591914.501587,192.168.1.5,192.168.1.4,1960986270,1175776536,257,0,1165402
778,1574591914.50199,192.168.1.4,192.168.1.5,1175776536,1960986527,79,1,1165481
779,1574591914.502121,192.168.1.4,192.168.1.5,1175776615,1960986527,79,1,1165560
780,1574591914.519035,192.168.1.5,192.168.1.4,3127882810,2494283442,483,0,1165077
781,1574591914.562185,192.168.1.4,192.168.1.5,2494283442,3127883293,403,1,1165480
782,1574591914.56565,192.168.1.5,192.168.1.4,3127883293,2494283845,61,0,1165419
783,1574591914.627862,192.168.1.5,192.168.1.4,2214391298,4017414697,107,0,1165312
784,1574591914.652327,192.168.1.5,192.168.1.4,2588137854,150903805,24,0,1165288
785,1574591914.653,192.168.1.4,192.168.1.5,150903805,2588137878,24,1,1165312
786,1574591914.654985,192.168.1.5,192.168.1.4,3031465314,4112217264,343,0,1164969
787,1574591914.655406,192.168.1.4,192.168.1.5,4112217264,3031465657,99,1,1165068
788,1574591914.655984,192.168.1.5,192.168.1.4,3031465657,4112217363,382,0,1164686
789,1574591914.657582,192.168.1.5,192.168.1.4,1481816970,4102909005,24,0,1164662
790,1574591914.658046,192.168.1.4,192.168.1.5,4102909005,1481816994,24,1,1164686
791,1574591914.659547,192.168.1.5,192.168.1.4,1346843379,190473761,343,0,1164343
792,1574591914.66273,192.168.1.4,192.168.1.5,190473761,1346843722,99,1,1164442
793,1574591914.663052,192.168.1.5,192.168.1.4,1346843722,190473860,382,0,1164060
794,1574591914.667487,192.168.1.4,192.168.1.5,4017414697,2214391405,1578,1,1165638
795,1574591914.675979,192.168.1.4,192.168.1.5,4112217363,3031466039,2266,1,1167904
796,1574591914.676847,192.168.1.5,192.168.1.4,3031466039,4112219629,74,0,1167830
797,1574591914.677049,192.168.1.5,192.168.1.4,3031466113,4112219629,247,0,1167583
798,1574591914.677283,192.168.1.4,192.168.1.5,4112219629,3031466360,79,1,1167662
799,1574591914.677391,192.168.1.4,192.168.1.5,4112219708,3031466360,79,1,1167741
800,1574591914.68019,192.168.1.4,192.168.1.5,190473860,1346844104,2266,1,1170007
801,1574591914.682369,192.168.1.5,192.168.1.4,1346844104,190476126,74,0,1169933
802,1574591914.682489,192.168.1.5,192.168.1.4,1346844178,190476126,247,0,1169686
803,1574591914.682749,192.168.1.4,192.168.1.5,190476126,1346844178,79,1,1169765
804,1574591914.6829,192.168.1.4,192.168.1.5,190476205,1346844425,79,1,1169844
805,1574591914.710299,192.168.1.4,192.168.1.5,4017416275,2214391405,14480,1,1184324
806,1574591914.710579,192.168.1.4,192.168.1.5,4017430755,2214391405,14480,1,1198804
807,1574591914.717359,192.168.1.4,192.168.1.5,4017445235,2214391405,129,1,1198933
808,1574591914.718246,192.168.1.5,192.168.1.4,2214391405,4017445364,61,0,1198872
809,1574591914.850961,192.168.1.5,192.168.1.4,3127883354,2494283845,633,0,1198239
810,1574591914.893591,192.168.1.4,192.168.1.5,2494283845,3127883987,227,1,1198466
811,1574591914.895334,192.168.1.5,192.168.1.4,3127883987,2494284072,61,0,1198405
812,1574591916.286019,192.168.1.5,192.168.1.4,3374263616,1846813988,24,0,1198381
813,1574591918.346458,192.168.1.4,192.168.1.5,930525130,4038307476,91,1,1198472
814,1574591918.346489,192.168.1.4,192.168.1.5,2828656183,1493636546,91,1,1198563
815,1574591918.346847,192.168.1.4,192.168.1.5,376823002,570821728,91,1,1198654
816,1574591918.346955,192.168.1.4,192.168.1.5,1668415064,285641416,91,1,1198745
817,1574591918.347287,192.168.1.5,192.168.1.4,4038307476,930525221,539,0,1198206
818,1574591918.347568,192.168.1.5,192.168.1.4,1493636546,2828656274,539,0,1197667
819,1574591918.347881,192.168.1.5,192.168.1.4,570821728,376823093,539,0,1197128
820,1574591918.348296,192.168.1.5,192.168.1.4,285641416,1668415155,539,0,1196589
821,1574591918.388255,192.168.1.4,192.168.1.5,1668415155,285641955,169,1,1196758
822,1574591918.389533,192.168.1.5,192.168.1.4,285641955,1668415324,73,0,1196685
823,1574591918.391163,192.168.1.4,192.168.1.5,930525221,4038308015,1470,1,1198155
824,1574591918.391988,192.168.1.4,192.168.1.5,2828656274,1493637085,1470,1,1199625
825,1574591918.396326,192.168.1.4,192.168.1.5,376823093,570822267,2070,1,1201695
826,1574591918.434077,192.168.1.4,192.168.1.5,2828657744,1493637085,4311,1,1206006
827,1574591918.434274,192.168.1.4,192.168.1.5,930526691,4038308015,4311,1,1210317
828,1574591918.43806,192.168.1.5,192.168.1.4,1493637085,2828662055,102,0,1210215
829,1574591918.438158,192.168.1.4,192.168.1.5,376825163,570822267,3711,1,1213926
830,1574591918.43983,192.168.1.5,192.168.1.4,4038308015,930531002,102,0,1213824
831,1574591918.441404,192.168.1.5,192.168.1.4,570822267,376828874,102,0,1213722
832,1574591918.441669,192.168.1.5,192.168.1.4,4038308117,930531002,24,0,1213698
833,1574591918.441873,192.168.1.5,192.168.1.4,1493637187,2828662055,108,0,1213590
834,1574591918.442096,192.168.1.5,192.168.1.4,3612499129,2180240294,24,0,1213566
835,1574591918.442252,192.168.1.5,192.168.1.4,2313422729,2004873553,24,0,1213542
836,1574591918.442369,192.168.1.5,192.168.1.4,570822369,376828874,24,0,1213518
837,1574591918.443224,192.168.1.4,192.168.1.5,930531002,4038308141,24,1,1213542
838,1574591918.444485,192.168.1.4,192.168.1.5,376828874,570822393,24,1,1213566
839,1574591918.450707,192.168.1.5,192.168.1.4,1493637295,2828662055,290,0,1213276
840,1574591918.450883,192.168.1.5,192.168.1.4,1493637585,2828662055,92,0,1213184
841,1574591918.451111,192.168.1.5,192.168.1.4,1493637677,2828662055,92,0,1213092
842,1574591918.45128,192.168.1.5,192.168.1.4,1493637769,2828662055,92,0,1213000
843,1574591918.451397,192.168.1.5,192.168.1.4,1493637861,2828662055,92,0,1212908
844,1574591918.484837,192.168.1.4,192.168.1.5,2828662055,1493637953,689,1,1213597
845,1574591918.48521,192.168.1.5,192.168.1.4,1493637953,2828662744,53,0,1213544
846,1574591918.491032,192.168.1.4,192.168.1.5,2885035482,457411157,91,1,1213635
847,1574591918.491503,192.168.1.5,192.168.1.4,457411157,2885035573,539,0,1213096
848,1574591918.495065,192.168.1.4,192.168.1.5,2828662744,1493638006,2070,1,1215166
849,1574591918.503776,192.168.1.5,192.168.1.4,3537816917,2692222112,343,0,1214823
850,1574591918.504106,192.168.1.4,192.168.1.5,2692222112,3537817260,99,1,1214922
851,1574591918.504809,192.168.1.5,192.168.1.4,3537817260,2692222211,382,0,1214540
852,1574591918.514344,192.168.1.4,192.168.1.5,2692222211,3537817642,2266,1,1216806
853,1574591918.515676,192.168.1.5,192.168.1.4,3537817642,2692224477,74,0,1216732
854,1574591918.515844,192.168.1.5,192.168.1.4,3537817716,2692224477,239,0,1216493
855,1574591918.516133,192.168.1.4,192.168.1.5,2692224477,3537817955,79,1,1216572
856,1574591918.517253,192.168.1.4,192.168.1.5,2692224556,3537817955,79,1,1216651
857,1574591918.527057,192.168.1.4,192.168.1.5,2885035573,457411696,2070,1,1218721
858,1574591918.538154,192.168.1.4,192.168.1.5,2828664814,1493638006,7267,1,1225988
859,1574591918.552822,192.168.1.5,192.168.1.4,2795716964,2229869394,343,0,1225645
860,1574591918.55319,192.168.1.4,192.168.1.5,2229869394,2795717307,99,1,1225744
861,1574591918.553709,192.168.1.5,192.168.1.4,2795717307,2229869493,382,0,1225362
862,1574591918.555422,192.168.1.5,192.168.1.4,3828543108,2614119491,343,0,1225019
863,1574591918.559687,192.168.1.4,192.168.1.5,2614119491,3828543451,99,1,1225118
864,1574591918.559998,192.168.1.5,192.168.1.4,3828543451,2614119590,382,0,1224736
865,1574591918.560129,192.168.1.5,192.168.1.4,1713385362,1799111503,343,0,1224393
866,1574591918.562911,192.168.1.5,192.168.1.4,2581590708,531119976,343,0,1224050
867,1574591918.563217,192.168.1.4,192.168.1.5,1799111503,1713385705,99,1,1224149
868,1574591918.563712,192.168.1.5,192.168.1.4,1713385705,1799111602,382,0,1223767
869,1574591918.57388,192.168.1.4,192.168.1.5,2885037643,457411696,3028,1,1226795
870,1574591918.578795,192.168.1.5,192.168.1.4,457411696,2885040671,148,0,1226647
871,1574591918.579961,192.168.1.4,192.168.1.5,531119976,2581591051,99,1,1226746
872,1574591918.580363,192.168.1.5,192.168.1.4,2581591051,531120075,382,0,1226364
873,1574591918.586649,192.168.1.4,192.168.1.5,2229869493,2795717689,2266,1,1228630
874,1574591918.587698,192.168.1.5,192.168.1.4,2795717689,2229871759,74,0,1228556
875,1574591918.587859,192.168.1.5,192.168.1.4,2795717763,2229871759,243,0,1228313
876,1574591918.593215,192.168.1.4,192.168.1.5,531120075,2581591433,2266,1,1230579
877,1574591918.594226,192.168.1.5,192.168.1.4,2581591433,531122341,74,0,1230505
878,1574591918.594341,192.168.1.5,192.168.1.4,2581591507,531122341,243,0,1230262
879,1574591918.595916,192.168.1.4,192.168.1.5,2614119590,3828543833,2266,1,1232528
880,1574591918.596202,192.168.1.4,192.168.1.5,2229871759,2795718006,79,1,1232607
881,1574591918.596263,192.168.1.4,192.168.1.5,2229871838,2795718006,79,1,1232686
882,1574591918.597666,192.168.1.5,192.168.1.4,3828543833,2614121856,74,0,1232612
883,1574591918.597781,192.168.1.5,192.168.1.4,3828543907,2614121856,243,0,1232369
884,1574591918.598817,192.168.1.4,192.168.1.5,1799111602,1713386087,2266,1,1234635
885,1574591918.599029,192.168.1.4,192.168.1.5,2614121856,3828544150,79,1,1234714
886,1574591918.599086,192.168.1.4,192.168.1.5,2614121935,3828544150,79,1,1234793
887,1574591918.599968,192.168.1.4,192.168.1.5,531122341,2581591750,79,1,1234872
888,1574591918.600171,192.168.1.5,192.168.1.4,1713386087,1799113868,74,0,1234798
889,1574591918.600236,192.168.1.4,192.168.1.5,531122420,2581591750,79,1,1234877
890,1574591918.600346,192.168.1.5,192.168.1.4,1713386161,1799113868,257,0,1234620
891,1574591918.600578,192.168.1.4,192.168.1.5,1799113868,1713386418,79,1,1234699
892,1574591918.600684,192.168.1.4,192.168.1.5,1799113947,1713386418,79,1,1234778
893,1574591918.615201,192.168.1.4,192.168.1.5,2885040671,457411844,296,1,1235074
894,1574591918.615752,192.168.1.5,192.168.1.4,457411844,2885040967,478,0,1234596
895,1574591918.625294,192.168.1.4,192.168.1.5,2004873553,2313422753,91,1,1234687
896,1574591918.625328,192.168.1.4,192.168.1.5,2004873644,2313422753,24,1,1234711
897,1574591918.650487,192.168.1.4,192.168.1.5,2885040967,457412322,594,1,1235305
898,1574591918.69152,192.168.1.4,192.168.1.5,3417769745,2940306390,91,1,1235396
899,1574591918.692154,192.168.1.5,192.168.1.4,2940306390,3417769836,539,0,1234857
900,1574591918.737624,192.168.1.4,192.168.1.5,3417769836,2940306929,2070,1,1236927
901,1574591918.778529,192.168.1.4,192.168.1.5,3417771906,2940306929,2978,1,1239905
902,1574591918.782475,192.168.1.5,192.168.1.4,2940306929,3417774884,115,0,1239790
903,1574591918.78383,192.168.1.5,192.168.1.4,2940307044,3417774884,410,0,1239380
904,1574591918.809923,192.168.1.4,192.168.1.5,1531477655,4022802030,91,1,1239471
905,1574591918.809967,192.168.1.4,192.168.1.5,1531477746,4022802030,24,1,1239495
906,1574591918.811221,192.168.1.4,192.168.1.5,70651606,3282506495,91,1,1239586
907,1574591918.812569,192.168.1.5,192.168.1.4,3282506495,70651697,539,0,1239047
908,1574591918.815007,192.168.1.4,192.168.1.5,3417774884,2940307454,923,1,1239970
909,1574591918.821724,192.168.1.5,192.168.1.4,2940307454,3417775807,412,0,1239558
910,1574591918.822226,192.168.1.5,192.168.1.4,285642028,1668415324,24,0,1239534
911,1574591918.822793,192.168.1.4,192.168.1.5,1668415324,285642052,24,1,1239558
912,1574591918.823948,192.168.1.5,192.168.1.4,2479995471,3294953724,343,0,1239215
913,1574591918.824373,192.168.1.4,192.168.1.5,3294953724,2479995814,99,1,1239314
914,1574591918.825158,192.168.1.5,192.168.1.4,2479995814,3294953823,382,0,1238932
915,1574591918.83615,192.168.1.4,192.168.1.5,3294953823,2479996196,2266,1,1241198
916,1574591918.83708,192.168.1.5,192.168.1.4,2479996196,3294956089,74,0,1241124
917,1574591918.83723,192.168.1.5,192.168.1.4,2479996270,3294956089,265,0,1240859
918,1574591918.83749,192.168.1.4,192.168.1.5,3294956089,2479996535,79,1,1240938
919,1574591918.840306,192.168.1.4,192.168.1.5,3294956168,2479996535,79,1,1241017
920,1574591918.856112,192.168.1.4,192.168.1.5,70651697,3282507034,169,1,1241186
921,1574591918.856148,192.168.1.4,192.168.1.5,3417775807,2940307866,1072,1,1242258
922,1574591918.863691,192.168.1.5,192.168.1.4,3282507034,70651866,73,0,1242185
923,1574591918.867112,192.168.1.5,192.168.1.4,3282507107,70651866,24,0,1242161
924,1574591918.867592,192.168.1.4,192.168.1.5,70651866,3282507131,24,1,1242185
925,1574591918.869722,192.168.1.5,192.168.1.4,699729300,1086578234,343,0,1241842
926,1574591918.87014,192.168.1.4,192.168.1.5,1086578234,699729643,99,1,1241941
927,1574591918.870441,192.168.1.5,192.168.1.4,699729643,1086578333,382,0,1241559
928,1574591918.880363,192.168.1.4,192.168.1.5,1086578333,699730025,2266,1,1243825
929,1574591918.88133,192.168.1.5,192.168.1.4,699730025,1086580599,74,0,1243751
930,1574591918.881723,192.168.1.4,192.168.1.5,1086580599,699730099,79,1,1243830
931,1574591918.881801,192.168.1.4,192.168.1.5,1086580678,699730099,79,1,1243909
932,1574591918.882089,192.168.1.5,192.168.1.4,699730099,1086580757,257,0,1243652
933,1574591918.896723,192.168.1.5,192.168.1.4,1272089062,234101133,24,0,1243628
934,1574591918.897268,192.168.1.4,192.168.1.5,234101133,1272089086,24,1,1243652
935,1574591918.899138,192.168.1.5,192.168.1.4,4289558476,963971643,343,0,1243309
936,1574591918.899598,192.168.1.4,192.168.1.5,963971643,4289558819,99,1,1243408
937,1574591918.899962,192.168.1.5,192.168.1.4,4289558819,963971742,382,0,1243026
938,1574591918.91199,192.168.1.4,192.168.1.5,963971742,4289559201,2266,1,1245292
939,1574591918.912966,192.168.1.5,192.168.1.4,4289559201,963974008,74,0,1245218
940,1574591918.913124,192.168.1.5,192.168.1.4,4289559275,963974008,235,0,1244983
941,1574591918.91331,192.168.1.4,192.168.1.5,963974008,4289559510,79,1,1245062
942,1574591918.915588,192.168.1.4,192.168.1.5,963974087,4289559510,79,1,1245141
943,1574591919.060206,192.168.1.4,192.168.1.5,2590573181,1734976356,91,1,1245232
944,1574591919.060614,192.168.1.5,192.168.1.4,1734976356,2590573272,539,0,1244693
945,1574591919.112619,192.168.1.4,192.168.1.5,2590573272,1734976895,169,1,1244862
946,1574591919.114702,192.168.1.5,192.168.1.4,1734976895,2590573441,73,0,1244789
947,1574591919.217419,192.168.1.4,192.168.1.5,991940947,3345435050,91,1,1244880
948,1574591919.21814,192.168.1.5,192.168.1.4,3345435050,991941038,539,0,1244341
949,1574591919.258409,192.168.1.4,192.168.1.5,991941038,3345435589,2070,1,1246411
950,1574591919.302463,192.168.1.4,192.168.1.5,991943108,3345435589,1756,1,1248167
951,1574591919.308914,192.168.1.5,192.168.1.4,3345435589,991944864,86,0,1248081
952,1574591919.309425,192.168.1.5,192.168.1.4,3345435675,991944864,108,0,1247973
953,1574591919.311874,192.168.1.5,192.168.1.4,3345435783,991944864,283,0,1247690
954,1574591919.34899,192.168.1.4,192.168.1.5,991944864,3345436066,617,1,1248307
955,1574591919.349383,192.168.1.5,192.168.1.4,3345436066,991945481,53,0,1248254
956,1574591919.351634,192.168.1.4,192.168.1.5,991945481,3345436119,961,1,1249215
957,1574591919.353566,192.168.1.5,192.168.1.4,3345436119,991946442,61,0,1249154
958,1574591919.481891,192.168.1.4,192.168.1.5,1085852729,1600951472,91,1,1249245
959,1574591919.481925,192.168.1.4,192.168.1.5,3179559062,2764856904,91,1,1249336
960,1574591919.482497,192.168.1.5,192.168.1.4,1600951472,1085852820,539,0,1248797
961,1574591919.482957,192.168.1.5,192.168.1.4,2764856904,3179559153,539,0,1248258
962,1574591919.518502,192.168.1.4,192.168.1.5,1085852820,1600952011,178,1,1248436
963,1574591919.520081,192.168.1.4,192.168.1.5,3179559153,2764857443,1440,1,1249876
964,1574591919.520532,192.168.1.5,192.168.1.4,1600952011,1085852998,73,0,1249803
965,1574591919.537723,192.168.1.4,192.168.1.5,1663061114,4055227188,91,1,1249894
966,1574591919.538232,192.168.1.5,192.168.1.4,4055227188,1663061205,539,0,1249355
967,1574591919.562455,192.168.1.4,192.168.1.5,3179560593,2764857443,2386,1,1251741
968,1574591919.568494,192.168.1.5,192.168.1.4,2764857443,3179562979,86,0,1251655
969,1574591919.568872,192.168.1.5,192.168.1.4,2764857529,3179562979,108,0,1251547
970,1574591919.57053,192.168.1.5,192.168.1.4,2764857637,3179562979,283,0,1251264
971,1574591919.603278,192.168.1.4,192.168.1.5,3179562979,2764857920,586,1,1251850
972,1574591919.603919,192.168.1.5,192.168.1.4,2764857920,3179563565,53,0,1251797
973,1574591919.605433,192.168.1.4,192.168.1.5,3179563565,2764857973,53,1,1251850
974,1574591919.646682,192.168.1.4,192.168.1.5,3179563618,2764857973,1046,1,1252896
975,1574591919.649896,192.168.1.5,192.168.1.4,2764857973,3179564664,61,0,1252835
976,1574591919.665111,192.168.1.4,192.168.1.5,1663061205,4055227727,2070,1,1254905
977,1574591919.706346,192.168.1.4,192.168.1.5,1663063275,4055227727,1038,1,1255943
978,1574591919.71223,192.168.1.5,192.168.1.4,4055227727,1663064313,148,0,1255795
979,1574591919.714769,192.168.1.5,192.168.1.4,4055227875,1663064313,115,0,1255680
980,1574591919.718028,192.168.1.5,192.168.1.4,4055227990,1663064313,563,0,1255117
981,1574591919.831175,192.168.1.4,192.168.1.5,1663064313,4055228553,349,1,1255466
982,1574591919.831823,192.168.1.5,192.168.1.4,4055228553,1663064662,60,0,1255406
983,1574591919.83286,192.168.1.4,192.168.1.5,1663064662,4055228613,60,1,1255466
984,1574591919.874387,192.168.1.4,192.168.1.5,1663064722,4055228613,249,1,1255715
985,1574591919.878215,192.168.1.5,192.168.1.4,1734976968,2590573441,24,0,1255691
986,1574591919.87898,192.168.1.4,192.168.1.5,2590573441,1734976992,24,1,1255715
987,1574591919.882267,192.168.1.5,192.168.1.4,4014794241,3721832605,343,0,1255372
988,1574591919.883009,192.168.1.4,192.168.1.5,3721832605,4014794584,99,1,1255471
989,1574591919.883582,192.168.1.5,192.168.1.4,4014794584,3721832704,382,0,1255089
990,1574591919.894964,192.168.1.4,192.168.1.5,3721832704,4014794966,2266,1,1257355
991,1574591919.896087,192.168.1.5,192.168.1.4,4014794966,3721834970,74,0,1257281
992,1574591919.896301,192.168.1.5,192.168.1.4,4014795040,3721834970,257,0,1257024
993,1574591919.896609,192.168.1.4,192.168.1.5,3721834970,4014795297,79,1,1257103
994,1574591919.896751,192.168.1.4,192.168.1.5,3721835049,4014795297,79,1,1257182
995,1574591921.776265,192.168.1.4,192.168.1.5,2180240294,3612499153,91,1,1257273
996,1574591921.776324,192.168.1.4,192.168.1.5,2180240385,3612499153,24,1,1257297
997,1574591922.308181,192.168.1.4,192.168.1.5,1502373259,143588757,91,1,1257388
998,1574591922.309143,192.168.1.5,192.168.1.4,143588757,1502373350,539,0,1256849
999,1574591922.353884,192.168.1.4,192.168.1.5,3122169899,1191479348,91,1,1256940
1000,1574591922.354636,192.168.1.5,192.168.1.4,1191479348,3122169990,539,0,1256401
1001,1574591922.357418,192.168.1.4,192.168.1.5,1502373350,143589296,2070,1,1258471
1002,1574591922.388981,192.168.1.4,192.168.1.5,3122169990,1191479887,2070,1,1260541
1003,1574591922.398457,192.168.1.4,192.168.1.5,1502375420,143589296,3990,1,1264531
1004,1574591922.402386,192.168.1.5,192.168.1.4,143589296,1502379410,86,0,1264445
1005,1574591922.403249,192.168.1.5,192.168.1.4,143589382,1502379410,883,0,1263562
1006,1574591922.430836,192.168.1.4,192.168.1.5,3122172060,1191479887,2381,1,1265943
1007,1574591922.43363,192.168.1.5,192.168.1.4,1191479887,3122174441,148,0,1265795
1008,1574591922.457189,192.168.1.4,192.168.1.5,1502379410,143590265,760,1,1266555
1009,1574591922.458362,192.168.1.4,192.168.1.5,3122174441,1191480035,296,1,1266851
1010,1574591922.459897,192.168.1.5,192.168.1.4,143590265,1502380170,1345,0,1265506
1011,1574591922.498756,192.168.1.4,192.168.1.5,1676008620,3570666202,91,1,1265597
1012,1574591922.499475,192.168.1.5,192.168.1.4,3570666202,1676008711,539,0,1265058
1013,1574591922.504028,192.168.1.4,192.168.1.5,1502380170,143591610,186,1,1265244
1014,1574591922.506161,192.168.1.5,192.168.1.4,143591610,1502380356,707,0,1264537
1015,1574591922.55249,192.168.1.4,192.168.1.5,1676008711,3570666741,2070,1,1266607
1016,1574591922.552713,192.168.1.4,192.168.1.5,1502380356,143592317,186,1,1266793
1017,1574591922.594861,192.168.1.4,192.168.1.5,1676010781,3570666741,1784,1,1268577
1018,1574591922.601593,192.168.1.5,192.168.1.4,3570666741,1676012565,148,0,1268429
1019,1574591922.637586,192.168.1.4,192.168.1.5,1676012565,3570666889,280,1,1268709
1020,1574591922.653423,192.168.1.4,192.168.1.5,3742766046,719220543,91,1,1268800
1021,1574591922.653461,192.168.1.4,192.168.1.5,3742766137,719220543,24,1,1268824
1022,1574591922.764868,192.168.1.4,192.168.1.5,3959882013,936151529,91,1,1268915
1023,1574591922.765195,192.168.1.4,192.168.1.5,1846813988,3374263640,91,1,1269006
1024,1574591922.765211,192.168.1.4,192.168.1.5,1846814079,3374263640,24,1,1269030
1025,1574591922.767112,192.168.1.5,192.168.1.4,936151529,3959882104,626,0,1268404
1026,1574591922.823941,192.168.1.4,192.168.1.5,3959882104,936152155,262,1,1268666
1027,1574591922.824945,192.168.1.5,192.168.1.4,936152155,3959882366,86,0,1268580
1028,1574591922.877548,192.168.1.4,192.168.1.5,3959882366,936152241,309,1,1268889
1029,1574591923.098765,192.168.1.4,192.168.1.5,1072609520,248013387,91,1,1268980
1030,1574591923.09954,192.168.1.5,192.168.1.4,248013387,1072609611,539,0,1268441
1031,1574591923.143947,192.168.1.4,192.168.1.5,1072609611,248013926,2070,1,1270511
1032,1574591923.189796,192.168.1.4,192.168.1.5,1072611681,248013926,5296,1,1275807
1033,1574591923.209674,192.168.1.5,192.168.1.4,248013926,1072616977,86,0,1275721
1034,1574591923.210054,192.168.1.4,192.168.1.5,385149836,2929085180,91,1,1275812
1035,1574591923.214354,192.168.1.5,192.168.1.4,2929085180,385149927,626,0,1275186
1036,1574591923.214575,192.168.1.5,192.168.1.4,248014012,1072616977,108,0,1275078
1037,1574591923.214773,192.168.1.5,192.168.1.4,2795718006,2229871917,24,0,1275054
1038,1574591923.215098,192.168.1.5,192.168.1.4,3828544150,2614122014,24,0,1275030
1039,1574591923.215266,192.168.1.5,192.168.1.4,2581591750,531122499,24,0,1275006
1040,1574591923.218482,192.168.1.5,192.168.1.4,248014120,1072616977,277,0,1274729
1041,1574591923.21863,192.168.1.5,192.168.1.4,248014397,1072616977,105,0,1274624
1042,1574591923.218809,192.168.1.5,192.168.1.4,248014502,1072616977,106,0,1274518
1043,1574591923.218957,192.168.1.5,192.168.1.4,248014608,1072616977,103,0,1274415
1044,1574591923.243523,192.168.1.4,192.168.1.5,1072616977,248014711,586,1,1275001
1045,1574591923.244081,192.168.1.5,192.168.1.4,248014711,1072617563,53,0,1274948
1046,1574591923.245096,192.168.1.4,192.168.1.5,1072617563,248014764,53,1,1275001
1047,1574591923.269396,192.168.1.4,192.168.1.5,385149927,2929085806,262,1,1275263
1048,1574591923.270533,192.168.1.5,192.168.1.4,2929085806,385150189,86,0,1275177
1049,1574591923.286358,192.168.1.4,192.168.1.5,1072617616,248014764,13032,1,1288209
1050,1574591923.286559,192.168.1.4,192.168.1.5,1072630648,248014764,10136,1,1298345
1051,1574591923.286643,192.168.1.4,192.168.1.5,1072640784,248014764,7600,1,1305945
1052,1574591923.297468,192.168.1.5,192.168.1.4,248014764,1072648384,61,0,1305884
1053,1574591923.299987,192.168.1.5,192.168.1.4,3220318360,3785662179,343,0,1305541
1054,1574591923.300563,192.168.1.4,192.168.1.5,3785662179,3220318703,99,1,1305640
1055,1574591923.301017,192.168.1.4,192.168.1.5,1072648384,248014825,2070,1,1307710
1056,1574591923.301278,192.168.1.5,192.168.1.4,3220318703,3785662278,382,0,1307328
1057,1574591923.30642,192.168.1.5,192.168.1.4,248014825,1072650454,105,0,1307223
1058,1574591923.306922,192.168.1.5,192.168.1.4,248014930,1072650454,103,0,1307120
1059,1574591923.307029,192.168.1.4,192.168.1.5,1072650454,248014930,5064,1,1312184
1060,1574591923.307966,192.168.1.4,192.168.1.5,1072655518,248015033,2070,1,1314254
1061,1574591923.310143,192.168.1.4,192.168.1.5,385150189,2929085892,309,1,1314563
1062,1574591923.314076,192.168.1.4,192.168.1.5,3785662278,3220319085,2266,1,1316829
1063,1574591923.315102,192.168.1.5,192.168.1.4,3220319085,3785664544,74,0,1316755
1064,1574591923.315215,192.168.1.5,192.168.1.4,3220319159,3785664544,257,0,1316498
1065,1574591923.315438,192.168.1.4,192.168.1.5,3785664544,3220319416,79,1,1316577
1066,1574591923.315499,192.168.1.4,192.168.1.5,3785664623,3220319416,79,1,1316656
1067,1574591923.321802,192.168.1.4,192.168.1.5,1072657588,248015033,16406,1,1333062
1068,1574591923.321924,192.168.1.4,192.168.1.5,1072673994,248015033,15928,1,1348990
1069,1574591923.322116,192.168.1.4,192.168.1.5,1072689922,248015033,478,1,1349468
1070,1574591923.322122,192.168.1.4,192.168.1.5,1072690400,248015033,2074,1,1351542
1071,1574591923.343101,192.168.1.4,192.168.1.5,1072692474,248015033,16406,1,1367948
1072,1574591923.34321,192.168.1.4,192.168.1.5,1072708880,248015033,16406,1,1384354
1073,1574591923.343241,192.168.1.4,192.168.1.5,1072725286,248015033,1758,1,1386112
1074,1574591923.35371,192.168.1.5,192.168.1.4,2267121689,2520481818,343,0,1385769
1075,1574591923.354079,192.168.1.4,192.168.1.5,2520481818,2267122032,99,1,1385868
1076,1574591923.354577,192.168.1.5,192.168.1.4,2267122032,2520481917,382,0,1385486
1077,1574591923.357156,192.168.1.5,192.168.1.4,3462890888,1799127929,343,0,1385143
1078,1574591923.365454,192.168.1.4,192.168.1.5,1799127929,3462891231,99,1,1385242
1079,1574591923.365908,192.168.1.5,192.168.1.4,3462891231,1799128028,382,0,1384860
1080,1574591923.365984,192.168.1.4,192.168.1.5,2520481917,2267122414,2266,1,1387126
1081,1574591923.366861,192.168.1.5,192.168.1.4,2267122414,2520484183,74,0,1387052
1082,1574591923.366979,192.168.1.5,192.168.1.4,2267122488,2520484183,235,0,1386817
1083,1574591923.373805,192.168.1.4,192.168.1.5,2520484183,2267122723,79,1,1386896
1084,1574591923.373829,192.168.1.4,192.168.1.5,2520484262,2267122723,79,1,1386975
1085,1574591923.376722,192.168.1.4,192.168.1.5,1799128028,3462891613,2266,1,1389241
1086,1574591923.377753,192.168.1.5,192.168.1.4,3462891613,1799130294,74,0,1389167
1087,1574591923.37786,192.168.1.5,192.168.1.4,3462891687,1799130294,235,0,1388932
1088,1574591923.378166,192.168.1.4,192.168.1.5,1799130294,3462891922,79,1,1389011
1089,1574591923.378242,192.168.1.4,192.168.1.5,1799130373,3462891922,79,1,1389090
1090,1574591923.386244,192.168.1.4,192.168.1.5,1072727044,248015033,16406,1,1405496
1091,1574591923.386311,192.168.1.4,192.168.1.5,1072743450,248015033,3533,1,1409029
1092,1574591923.406598,192.168.1.5,192.168.1.4,248015033,1072746983,61,0,1408968
1093,1574591923.421887,192.168.1.4,192.168.1.5,1273635723,3591138233,91,1,1409059
1094,1574591923.422343,192.168.1.5,192.168.1.4,3591138233,1273635814,539,0,1408520
1095,1574591923.460295,192.168.1.4,192.168.1.5,1273635814,3591138772,2070,1,1410590
1096,1574591923.502154,192.168.1.4,192.168.1.5,1273637884,3591138772,3188,1,1413778
1097,1574591923.504833,192.168.1.5,192.168.1.4,3591138772,1273641072,148,0,1413630
1098,1574591923.538099,192.168.1.4,192.168.1.5,1273641072,3591138920,73,1,1413703
1099,1574591923.540305,192.168.1.5,192.168.1.4,3591138920,1273641145,417,0,1413286
1100,1574591923.542204,192.168.1.5,192.168.1.4,3570666889,1676012845,24,0,1413262
1101,1574591923.542814,192.168.1.4,192.168.1.5,1676012845,3570666914,24,1,1413286
1102,1574591923.54476,192.168.1.5,192.168.1.4,1633042720,2585293200,343,0,1412943
1103,1574591923.545124,192.168.1.4,192.168.1.5,2585293200,1633043063,99,1,1413042
1104,1574591923.545574,192.168.1.5,192.168.1.4,1633043063,2585293299,382,0,1412660
1105,1574591923.560544,192.168.1.4,192.168.1.5,2585293299,1633043445,2266,1,1414926
1106,1574591923.561438,192.168.1.5,192.168.1.4,1633043445,2585295565,74,0,1414852
1107,1574591923.561634,192.168.1.5,192.168.1.4,1633043519,2585295565,235,0,1414617
1108,1574591923.561955,192.168.1.4,192.168.1.5,2585295565,1633043754,79,1,1414696
1109,1574591923.562085,192.168.1.4,192.168.1.5,2585295644,1633043754,79,1,1414775
1110,1574591923.57947,192.168.1.4,192.168.1.5,1273641145,3591139337,2070,1,1416845
1111,1574591923.593948,192.168.1.4,192.168.1.5,1273643215,3591139337,14480,1,1431325
1112,1574591923.594349,192.168.1.4,192.168.1.5,1273657695,3591139337,23888,1,1455213
1113,1574591923.634575,192.168.1.4,192.168.1.5,1273681583,3591139337,5360,1,1460573
1114,1574591923.737016,192.168.1.5,192.168.1.4,1191480035,3122174737,24,0,1460549
1115,1574591923.737569,192.168.1.4,192.168.1.5,3122174737,1191480060,24,1,1460573
1116,1574591923.738972,192.168.1.5,192.168.1.4,2031148398,4176644698,343,0,1460230
1117,1574591923.739314,192.168.1.4,192.168.1.5,4176644698,2031148741,99,1,1460329
1118,1574591923.739742,192.168.1.5,192.168.1.4,2031148741,4176644797,382,0,1459947
1119,1574591923.743472,192.168.1.5,192.168.1.4,3591139337,1273686943,24,0,1459923
1120,1574591923.74405,192.168.1.4,192.168.1.5,1273686943,3591139361,24,1,1459947
1121,1574591923.746041,192.168.1.5,192.168.1.4,2268398094,3496072181,343,0,1459604
1122,1574591923.750932,192.168.1.4,192.168.1.5,3496072181,2268398437,99,1,1459703
1123,1574591923.751217,192.168.1.5,192.168.1.4,2268398437,3496072280,382,0,1459321
1124,1574591923.75469,192.168.1.4,192.168.1.5,4176644797,2031149123,2266,1,1461587
1125,1574591923.755901,192.168.1.5,192.168.1.4,2031149123,4176647063,74,0,1461513
1126,1574591923.756072,192.168.1.5,192.168.1.4,2031149197,4176647063,231,0,1461282
1127,1574591923.75655,192.168.1.4,192.168.1.5,4176647063,2031149428,79,1,1461361
1128,1574591923.756701,192.168.1.4,192.168.1.5,4176647142,2031149428,79,1,1461440
1129,1574591923.764506,192.168.1.4,192.168.1.5,3496072280,2268398819,2266,1,1463706
1130,1574591923.765552,192.168.1.5,192.168.1.4,2268398819,3496074546,74,0,1463632
1131,1574591923.765895,192.168.1.4,192.168.1.5,3496074546,2268398893,79,1,1463711
1132,1574591923.765973,192.168.1.4,192.168.1.5,3496074625,2268398893,79,1,1463790
1133,1574591923.766327,192.168.1.5,192.168.1.4,2268398893,3496074704,231,0,1463559
1134,1574591924.309571,192.168.1.4,192.168.1.5,4112219787,3031466360,91,1,1463650
1135,1574591924.309647,192.168.1.4,192.168.1.5,1175776694,1960986527,91,1,1463741
1136,1574591924.310669,192.168.1.5,192.168.1.4,3031466360,4112219878,539,0,1463202
1137,1574591924.311567,192.168.1.5,192.168.1.4,1960986527,1175776785,539,0,1462663
1138,1574591924.354188,192.168.1.4,192.168.1.5,4112219878,3031466899,2070,1,1464733
1139,1574591924.354387,192.168.1.4,192.168.1.5,1175776785,1960987066,2070,1,1466803
1140,1574591924.394464,192.168.1.4,192.168.1.5,1175778855,1960987066,1010,1,1467813
1141,1574591924.394504,192.168.1.4,192.168.1.5,4112221948,3031466899,1890,1,1469703
1142,1574591924.402732,192.168.1.5,192.168.1.4,3031466899,4112223838,86,0,1469617
1143,1574591924.407719,192.168.1.5,192.168.1.4,1960987066,1175779865,86,0,1469531
1144,1574591924.408277,192.168.1.5,192.168.1.4,3031466985,4112223838,108,0,1469423
1145,1574591924.408463,192.168.1.5,192.168.1.4,1346844425,190476284,24,0,1469399
1146,1574591924.409882,192.168.1.5,192.168.1.4,1960987152,1175779865,108,0,1469291
1147,1574591924.411627,192.168.1.5,192.168.1.4,1713386418,1799114026,24,0,1469267
1148,1574591924.411954,192.168.1.5,192.168.1.4,699730356,1086580757,24,0,1469243
1149,1574591924.412167,192.168.1.5,192.168.1.4,4014795297,3721835128,24,0,1469219
1150,1574591924.412341,192.168.1.5,192.168.1.4,3220319416,3785664702,24,0,1469195
1151,1574591924.414178,192.168.1.5,192.168.1.4,3031467093,4112223838,296,0,1468899
1152,1574591924.414378,192.168.1.5,192.168.1.4,3031467389,4112223838,96,0,1468803
1153,1574591924.417252,192.168.1.5,192.168.1.4,1960987260,1175779865,397,0,1468406
1154,1574591924.418572,192.168.1.5,192.168.1.4,1960987657,1175779865,133,0,1468273
1155,1574591924.418819,192.168.1.5,192.168.1.4,1960987790,1175779865,98,0,1468175
1156,1574591924.418934,192.168.1.5,192.168.1.4,1960987888,1175779865,97,0,1468078
1157,1574591924.419105,192.168.1.5,192.168.1.4,1960987985,1175779865,296,0,1467782
1158,1574591924.436308,192.168.1.4,192.168.1.5,4112223838,3031467485,586,1,1468368
1159,1574591924.436652,192.168.1.5,192.168.1.4,3031467485,4112224424,53,0,1468315
1160,1574591924.439253,192.168.1.4,192.168.1.5,4112224424,3031467538,53,1,1468368
1161,1574591924.443923,192.168.1.4,192.168.1.5,1175779865,1960988281,586,1,1468954
1162,1574591924.445995,192.168.1.5,192.168.1.4,1960988281,1175780451,53,0,1468901
1163,1574591924.446495,192.168.1.4,192.168.1.5,1175780451,1960988334,53,1,1468954
1164,1574591924.469966,192.168.1.4,192.168.1.5,190476284,1346844449,91,1,1469045
1165,1574591924.470256,192.168.1.4,192.168.1.5,190476375,1346844449,24,1,1469069
1166,1574591924.485099,192.168.1.4,192.168.1.5,4112224477,3031467538,1756,1,1470825
1167,1574591924.488558,192.168.1.5,192.168.1.4,3031467538,4112226233,61,0,1470764
1168,1574591924.490281,192.168.1.4,192.168.1.5,1175780504,1960988334,13032,1,1483796
1169,1574591924.490437,192.168.1.4,192.168.1.5,1175793536,1960988334,11584,1,1495380
1170,1574591924.491002,192.168.1.4,192.168.1.5,1175805120,1960988334,367,1,1495747
1171,1574591924.496127,192.168.1.4,192.168.1.5,1175805487,1960988334,2070,1,1497817
1172,1574591924.496177,192.168.1.4,192.168.1.5,1175807557,1960988334,2070,1,1499887
1173,1574591924.496196,192.168.1.4,192.168.1.5,1175809627,1960988334,2070,1,1501957
1174,1574591924.514205,192.168.1.5,192.168.1.4,3586010402,2712073989,343,0,1501614
1175,1574591924.514768,192.168.1.4,192.168.1.5,2712073989,3586010745,99,1,1501713
1176,1574591924.515119,192.168.1.5,192.168.1.4,3586010745,2712074088,382,0,1501331
1177,1574591924.517878,192.168.1.5,192.168.1.4,1960988334,1175811697,61,0,1501270
1178,1574591924.518546,192.168.1.4,192.168.1.5,1175811697,1960988395,16406,1,1517676
1179,1574591924.518731,192.168.1.4,192.168.1.5,1175828103,1960988395,10021,1,1527697
1180,1574591924.530899,192.168.1.4,192.168.1.5,2712074088,3586011127,2266,1,1529963
1181,1574591924.531798,192.168.1.5,192.168.1.4,3586011127,2712076354,74,0,1529889
1182,1574591924.531976,192.168.1.5,192.168.1.4,3586011201,2712076354,241,0,1529648
1183,1574591924.532256,192.168.1.4,192.168.1.5,2712076354,3586011442,79,1,1529727
1184,1574591924.5324,192.168.1.4,192.168.1.5,2712076433,3586011442,79,1,1529806
1185,1574591924.622957,192.168.1.5,192.168.1.4,3031467599,4112226233,122,0,1529684
1186,1574591924.642531,192.168.1.5,192.168.1.4,1960988395,1175838124,342,0,1529342
1187,1574591924.643801,192.168.1.5,192.168.1.4,3127884048,2494284072,607,0,1528735
1188,1574591924.663127,192.168.1.4,192.168.1.5,4112226233,3031467721,682,1,1529417
1189,1574591924.664484,192.168.1.5,192.168.1.4,3031467721,4112226915,61,0,1529356
1190,1574591924.678922,192.168.1.4,192.168.1.5,1175838124,1960988737,8660,1,1538016
1191,1574591924.679895,192.168.1.4,192.168.1.5,1175846784,1960988737,2858,1,1540874
1192,1574591924.680321,192.168.1.4,192.168.1.5,1175849642,1960988737,1034,1,1541908
1193,1574591924.68107,192.168.1.5,192.168.1.4,1960988737,1175850676,61,0,1541847
1194,1574591924.690036,192.168.1.4,192.168.1.5,2494284072,3127884655,162,1,1542009
1195,1574591924.691769,192.168.1.5,192.168.1.4,3127884655,2494284234,61,0,1541948
1196,1574591925.027815,192.168.1.4,192.168.1.5,2614122014,3828544174,91,1,1542039
1197,1574591925.027842,192.168.1.4,192.168.1.5,2614122105,3828544174,24,1,1542063
1198,1574591925.028566,192.168.1.4,192.168.1.5,2229871917,2795718030,91,1,1542154
1199,1574591925.028881,192.168.1.4,192.168.1.5,2229872008,2795718030,24,1,1542178
1200,1574591925.035475,192.168.1.5,192.168.1.4,1960988798,1175850676,167,0,1542011
1201,1574591925.040294,192.168.1.5,192.168.1.4,1960988965,1175850676,114,0,1541897
1202,1574591925.045439,192.168.1.5,192.168.1.4,1960989079,1175850676,297,0,1541600
1203,1574591925.046936,192.168.1.5,192.168.1.4,1960989376,1175850676,95,0,1541505
1204,1574591925.062375,192.168.1.5,192.168.1.4,1960989471,1175850676,94,0,1541411
1205,1574591925.063869,192.168.1.5,192.168.1.4,3127884716,2494284234,476,0,1540935
1206,1574591925.069477,192.168.1.4,192.168.1.5,1175850676,1960989565,1626,1,1542561
1207,1574591925.076132,192.168.1.5,192.168.1.4,1960989565,1175852302,116,0,1542445
1208,1574591925.077096,192.168.1.4,192.168.1.5,1175852302,1960989681,11141,1,1553586
1209,1574591925.07864,192.168.1.5,192.168.1.4,1960989681,1175863443,61,0,1553525
1210,1574591925.079169,192.168.1.4,192.168.1.5,1175863443,1960989742,1438,1,1554963
1211,1574591925.081225,192.168.1.5,192.168.1.4,2214391466,4017445364,163,0,1554800
1212,1574591925.081372,192.168.1.5,192.168.1.4,2214391629,4017445364,61,0,1554739
1213,1574591925.087931,192.168.1.5,192.168.1.4,1960989742,1175864881,58,0,1554681
1214,1574591925.088096,192.168.1.5,192.168.1.4,1960989800,1175864881,58,0,1554623
1215,1574591925.088684,192.168.1.4,192.168.1.5,1175864881,1960989858,16406,1,1571029
1216,1574591925.088766,192.168.1.4,192.168.1.5,1175881287,1960989858,12586,1,1583615
1217,1574591925.090852,192.168.1.4,192.168.1.5,1175893873,1960989858,2070,1,1585685
1218,1574591925.103696,192.168.1.5,192.168.1.4,1960989858,1175895943,94,0,1585591
1219,1574591925.104147,192.168.1.4,192.168.1.5,1175895943,1960989952,16406,1,1601997
1220,1574591925.104277,192.168.1.4,192.168.1.5,1175912349,1960989952,15622,1,1617619
1221,1574591925.106,192.168.1.5,192.168.1.4,3127885192,2494284234,427,0,1617192
1222,1574591925.11263,192.168.1.4,192.168.1.5,2494284234,3127885619,163,1,1617355
1223,1574591925.113844,192.168.1.5,192.168.1.4,3127885619,2494284397,61,0,1617294
1224,1574591925.116098,192.168.1.4,192.168.1.5,1175927971,1960989952,16406,1,1633700
1225,1574591925.116211,192.168.1.4,192.168.1.5,1175944377,1960989952,16406,1,1650106
1226,1574591925.116235,192.168.1.4,192.168.1.5,1175960783,1960989952,1286,1,1651392
1227,1574591925.116352,192.168.1.4,192.168.1.5,4017445364,2214391690,61,1,1651453
1228,1574591925.129975,192.168.1.4,192.168.1.5,1175962069,1960989952,16406,1,1667859
1229,1574591925.130067,192.168.1.4,192.168.1.5,1175978475,1960989952,16406,1,1684265
1230,1574591925.130084,192.168.1.4,192.168.1.5,1175994881,1960989952,1286,1,1685551
1231,1574591925.136917,192.168.1.5,192.168.1.4,1960989952,1175996167,297,0,1685254
1232,1574591925.137377,192.168.1.4,192.168.1.5,1175996167,1960990249,4633,1,1689887
1233,1574591925.138595,192.168.1.5,192.168.1.4,1960990249,1176000800,61,0,1689826
1234,1574591925.139528,192.168.1.4,192.168.1.5,1176000800,1960990310,1574,1,1691400
1235,1574591925.151291,192.168.1.4,192.168.1.5,2494284397,3127885680,93,1,1691493
1236,1574591925.158123,192.168.1.4,192.168.1.5,4017445425,2214391690,4344,1,1695837
1237,1574591925.158283,192.168.1.4,192.168.1.5,4017449769,2214391690,10136,1,1705973
1238,1574591925.158458,192.168.1.4,192.168.1.5,4017459905,2214391690,1926,1,1707899
1239,1574591925.158516,192.168.1.4,192.168.1.5,4017461831,2214391690,8688,1,1716587
1240,1574591925.158653,192.168.1.4,192.168.1.5,4017470519,2214391690,5204,1,1721791
1241,1574591925.160147,192.168.1.5,192.168.1.4,2214391690,4017475723,61,0,1721730
1242,1574591925.176287,192.168.1.4,192.168.1.5,1176002374,1960990310,16406,1,1738136
1243,1574591925.176445,192.168.1.4,192.168.1.5,1176018780,1960990310,16406,1,1754542
1244,1574591925.176691,192.168.1.4,192.168.1.5,1176035186,1960990310,1411,1,1755953
1245,1574591925.180499,192.168.1.4,192.168.1.5,1176036597,1960990310,16406,1,1772359
1246,1574591925.180644,192.168.1.4,192.168.1.5,1176053003,1960990310,16406,1,1788765
1247,1574591925.180767,192.168.1.4,192.168.1.5,1176069409,1960990310,498,1,1789263
1248,1574591925.194319,192.168.1.4,192.168.1.5,2494284490,3127885680,92,1,1789355
1249,1574591925.195105,192.168.1.5,192.168.1.4,3127885680,2494284582,61,0,1789294
1250,1574591925.222326,192.168.1.4,192.168.1.5,1176069907,1960990310,3511,1,1792805
1251,1574591925.222924,192.168.1.5,192.168.1.4,1960990310,1176073418,61,0,1792744
1252,1574591925.261191,192.168.1.4,192.168.1.5,2692224635,3537817955,91,1,1792835
1253,1574591925.26318,192.168.1.5,192.168.1.4,3537817955,2692224726,539,0,1792296
1254,1574591925.297845,192.168.1.4,192.168.1.5,2692224726,3537818494,169,1,1792465
1255,1574591925.300487,192.168.1.5,192.168.1.4,3537818494,2692224895,73,0,1792392
1256,1574591925.301863,192.168.1.5,192.168.1.4,3537818567,2692224895,1016,0,1791376
1257,1574591925.317131,192.168.1.5,192.168.1.4,1960990371,1176073418,105,0,1791271
1258,1574591925.370822,192.168.1.4,192.168.1.5,2692224895,3537819583,686,1,1791957
1259,1574591925.370846,192.168.1.4,192.168.1.5,1176073418,1960990476,2070,1,1794027
1260,1574591925.398421,192.168.1.5,192.168.1.4,1960990476,1176075488,117,0,1793910
1261,1574591925.398999,192.168.1.4,192.168.1.5,1176075488,1960990593,9821,1,1803731
1262,1574591925.400688,192.168.1.5,192.168.1.4,1960990593,1176085309,61,0,1803670
1263,1574591925.402579,192.168.1.5,192.168.1.4,1960990654,1176085309,112,0,1803558
1264,1574591925.409317,192.168.1.5,192.168.1.4,3127885741,2494284582,576,0,1802982
1265,1574591925.437158,192.168.1.4,192.168.1.5,1176085309,1960990766,2070,1,1805052
1266,1574591925.457168,192.168.1.4,192.168.1.5,2494284582,3127886317,162,1,1805214
1267,1574591925.463753,192.168.1.5,192.168.1.4,3127886317,2494284744,61,0,1805153
1268,1574591925.470696,192.168.1.5,192.168.1.4,3127886378,2494284744,438,0,1804715
1269,1574591925.478191,192.168.1.4,192.168.1.5,1176087379,1960990766,4582,1,1809297
1270,1574591925.479827,192.168.1.5,192.168.1.4,1960990766,1176091961,61,0,1809236
1271,1574591925.511346,192.168.1.4,192.168.1.5,2494284744,3127886816,163,1,1809399
1272,1574591925.513722,192.168.1.5,192.168.1.4,3127886816,2494284907,61,0,1809338
1273,1574591925.552724,192.168.1.5,192.168.1.4,3127886877,2494284907,576,0,1808762
1274,1574591925.587634,192.168.1.5,192.168.1.4,2836220320,2773289848,343,0,1808419
1275,1574591925.587956,192.168.1.4,192.168.1.5,2773289848,2836220663,99,1,1808518
1276,1574591925.588458,192.168.1.5,192.168.1.4,2836220663,2773289947,382,0,1808136
1277,1574591925.596675,192.168.1.4,192.168.1.5,2494284907,3127887453,162,1,1808298
1278,1574591925.598324,192.168.1.4,192.168.1.5,2773289947,2836221045,2266,1,1810564
1279,1574591925.599302,192.168.1.5,192.168.1.4,2836221045,2773292213,74,0,1810490
1280,1574591925.599448,192.168.1.5,192.168.1.4,2836221119,2773292213,261,0,1810229
1281,1574591925.599708,192.168.1.4,192.168.1.5,2773292213,2836221380,79,1,1810308
1282,1574591925.600326,192.168.1.4,192.168.1.5,2773292292,2836221380,79,1,1810387
1283,1574591925.601175,192.168.1.5,192.168.1.4,3127887453,2494285069,61,0,1810326
1284,1574591925.663278,192.168.1.5,192.168.1.4,203465840,2931218983,343,0,1809983
1285,1574591925.663597,192.168.1.4,192.168.1.5,2931218983,203466183,99,1,1810082
1286,1574591925.664062,192.168.1.5,192.168.1.4,203466183,2931219082,382,0,1809700
1287,1574591925.673942,192.168.1.4,192.168.1.5,2931219082,203466565,2266,1,1811966
1288,1574591925.674948,192.168.1.5,192.168.1.4,203466565,2931221348,74,0,1811892
1289,1574591925.675079,192.168.1.5,192.168.1.4,203466639,2931221348,265,0,1811627
1290,1574591925.675329,192.168.1.4,192.168.1.5,2931221348,203466904,79,1,1811706
1291,1574591925.677165,192.168.1.4,192.168.1.5,2931221427,203466904,79,1,1811785
1292,1574591925.726657,192.168.1.5,192.168.1.4,22395423,2329713776,343,0,1811442
1293,1574591925.727126,192.168.1.4,192.168.1.5,2329713776,22395766,99,1,1811541
1294,1574591925.727403,192.168.1.5,192.168.1.4,22395766,2329713875,382,0,1811159
1295,1574591925.736851,192.168.1.4,192.168.1.5,2329713875,22396148,2266,1,1813425
1296,1574591925.73769,192.168.1.5,192.168.1.4,22396148,2329716141,74,0,1813351
1297,1574591925.737816,192.168.1.5,192.168.1.4,22396222,2329716141,265,0,1813086
1298,1574591925.738147,192.168.1.4,192.168.1.5,2329716141,22396487,79,1,1813165
1299,1574591925.738221,192.168.1.4,192.168.1.5,2329716220,22396487,79,1,1813244
1300,1574591925.772733,192.168.1.4,192.168.1.5,531122499,2581591774,91,1,1813335
1301,1574591925.772756,192.168.1.4,192.168.1.5,531122590,2581591774,24,1,1813359
1302,1574591926.122137,192.168.1.4,192.168.1.5,1799114026,1713386442,91,1,1813450
1303,1574591926.122178,192.168.1.4,192.168.1.5,1799114117,1713386442,24,1,1813474
1304,1574591926.875308,192.168.1.4,192.168.1.5,3294956247,2479996535,91,1,1813565
1305,1574591926.87614,192.168.1.5,192.168.1.4,2479996535,3294956338,539,0,1813026
1306,1574591926.915847,192.168.1.4,192.168.1.5,3294956338,2479997074,2070,1,1815096
1307,1574591926.958495,192.168.1.4,192.168.1.5,3294958408,2479997074,810,1,1815906
1308,1574591926.963179,192.168.1.5,192.168.1.4,2479997074,3294959218,86,0,1815820
1309,1574591926.965327,192.168.1.5,192.168.1.4,2479997160,3294959218,108,0,1815712
1310,1574591926.965764,192.168.1.5,192.168.1.4,203466904,2931221506,24,0,1815688
1311,1574591926.966158,192.168.1.5,192.168.1.4,22396487,2329716299,24,0,1815664
1312,1574591926.972413,192.168.1.5,192.168.1.4,2479997268,3294959218,359,0,1815305
1313,1574591926.972666,192.168.1.5,192.168.1.4,2479997627,3294959218,435,0,1814870
1314,1574591926.97288,192.168.1.5,192.168.1.4,2479998062,3294959218,324,0,1814546
1315,1574591926.99666,192.168.1.4,192.168.1.5,3294959218,2479998386,586,1,1815132
1316,1574591926.997306,192.168.1.5,192.168.1.4,2479998386,3294959804,53,0,1815079
1317,1574591927.000485,192.168.1.4,192.168.1.5,3294959804,2479998439,53,1,1815132
1318,1574591927.042215,192.168.1.4,192.168.1.5,3294959857,2479998439,1132,1,1816264
1319,1574591927.056867,192.168.1.5,192.168.1.4,2479998439,3294960989,61,0,1816203
1320,1574591927.209276,192.168.1.4,192.168.1.5,1086580757,699730380,91,1,1816294
1321,1574591927.209682,192.168.1.4,192.168.1.5,963974166,4289559510,91,1,1816385
1322,1574591927.209705,192.168.1.4,192.168.1.5,1086580848,699730380,24,1,1816409
1323,1574591927.212387,192.168.1.5,192.168.1.4,4289559510,963974257,539,0,1815870
1324,1574591927.265705,192.168.1.4,192.168.1.5,963974257,4289560049,2070,1,1817940
1325,1574591927.30651,192.168.1.4,192.168.1.5,963976327,4289560049,2686,1,1820626
1326,1574591927.309912,192.168.1.5,192.168.1.4,4289560049,963979013,115,0,1820511
1327,1574591927.311741,192.168.1.5,192.168.1.4,4289560164,963979013,560,0,1819951
1328,1574591927.341044,192.168.1.4,192.168.1.5,963979013,4289560724,280,1,1820231
1329,1574591927.382363,192.168.1.4,192.168.1.5,963979293,4289560724,732,1,1820963
1330,1574591927.38478,192.168.1.5,192.168.1.4,4289560724,963980025,487,0,1820476
1331,1574591927.416213,192.168.1.4,192.168.1.5,963980025,4289561211,409,1,1820885
1332,1574591927.417852,192.168.1.5,192.168.1.4,4289561211,963980434,484,0,1820401
1333,1574591927.437541,192.168.1.5,192.168.1.4,2794916253,2332606776,343,0,1820058
1334,1574591927.438014,192.168.1.4,192.168.1.5,2332606776,2794916596,99,1,1820157
1335,1574591927.438456,192.168.1.5,192.168.1.4,2794916596,2332606875,382,0,1819775
1336,1574591927.442541,192.168.1.5,192.168.1.4,3051476300,1325424512,343,0,1819432
1337,1574591927.446694,192.168.1.4,192.168.1.5,1325424512,3051476643,99,1,1819531
1338,1574591927.447162,192.168.1.5,192.168.1.4,3051476643,1325424611,382,0,1819149
1339,1574591927.448624,192.168.1.4,192.168.1.5,963980434,4289561695,409,1,1819558
1340,1574591927.46183,192.168.1.5,192.168.1.4,1406838853,1559213334,343,0,1819215
1341,1574591927.465861,192.168.1.4,192.168.1.5,1559213334,1406839196,99,1,1819314
1342,1574591927.466232,192.168.1.5,192.168.1.4,1406839196,1559213433,382,0,1818932
1343,1574591927.475345,192.168.1.5,192.168.1.4,4289561695,963980843,24,0,1818908
1344,1574591927.476462,192.168.1.4,192.168.1.5,963980843,4289561719,24,1,1818932
1345,1574591927.478752,192.168.1.4,192.168.1.5,2332606875,2794916978,2266,1,1821198
1346,1574591927.481711,192.168.1.5,192.168.1.4,2794916978,2332609141,74,0,1821124
1347,1574591927.481873,192.168.1.5,192.168.1.4,2794917052,2332609141,235,0,1820889
1348,1574591927.482296,192.168.1.4,192.168.1.5,2332609141,2794917287,79,1,1820968
1349,1574591927.482318,192.168.1.4,192.168.1.5,2332609220,2794917287,79,1,1821047
1350,1574591927.484072,192.168.1.4,192.168.1.5,1325424611,3051477025,2266,1,1823313
1351,1574591927.485853,192.168.1.5,192.168.1.4,3051477025,1325426877,74,0,1823239
1352,1574591927.486256,192.168.1.4,192.168.1.5,1325426877,3051477099,79,1,1823318
1353,1574591927.486349,192.168.1.4,192.168.1.5,1325426956,3051477099,79,1,1823397
1354,1574591927.487548,192.168.1.5,192.168.1.4,3537819583,2692225581,24,0,1823373
1355,1574591927.487992,192.168.1.4,192.168.1.5,2692225581,3537819607,24,1,1823397
1356,1574591927.489292,192.168.1.5,192.168.1.4,3051477099,1325427035,235,0,1823162
1357,1574591927.492679,192.168.1.4,192.168.1.5,1559213433,1406839578,2266,1,1825428
1358,1574591927.495138,192.168.1.5,192.168.1.4,1406839578,1559215699,74,0,1825354
1359,1574591927.495308,192.168.1.5,192.168.1.4,1406839652,1559215699,247,0,1825107
1360,1574591927.495475,192.168.1.5,192.168.1.4,2269216645,4027430722,343,0,1824764
1361,1574591927.495765,192.168.1.4,192.168.1.5,1559215699,1406839899,79,1,1824843
1362,1574591927.49589,192.168.1.4,192.168.1.5,1559215778,1406839899,79,1,1824922
1363,1574591927.496699,192.168.1.4,192.168.1.5,4027430722,2269216988,99,1,1825021
1364,1574591927.497319,192.168.1.5,192.168.1.4,2269216988,4027430821,382,0,1824639
1365,1574591927.497734,192.168.1.5,192.168.1.4,2183153290,3757063463,343,0,1824296
1366,1574591927.503856,192.168.1.4,192.168.1.5,3757063463,2183153633,99,1,1824395
1367,1574591927.504326,192.168.1.5,192.168.1.4,2183153633,3757063562,382,0,1824013
1368,1574591927.506996,192.168.1.5,192.168.1.4,4055228613,1663064971,306,0,1823707
1369,1574591927.521294,192.168.1.4,192.168.1.5,3757063562,2183154015,2266,1,1825973
1370,1574591927.522706,192.168.1.5,192.168.1.4,2183154015,3757065828,74,0,1825899
1371,1574591927.522877,192.168.1.5,192.168.1.4,2183154089,3757065828,233,0,1825666
1372,1574591927.523174,192.168.1.4,192.168.1.5,4027430821,2269217370,2266,1,1827932
1373,1574591927.523716,192.168.1.4,192.168.1.5,3757065828,2183154322,79,1,1828011
1374,1574591927.523818,192.168.1.4,192.168.1.5,3757065907,2183154322,79,1,1828090
1375,1574591927.524948,192.168.1.5,192.168.1.4,2269217370,4027433087,74,0,1828016
1376,1574591927.525178,192.168.1.5,192.168.1.4,2269217444,4027433087,237,0,1827779
1377,1574591927.525444,192.168.1.4,192.168.1.5,4027433087,2269217681,79,1,1827858
1378,1574591927.525627,192.168.1.4,192.168.1.5,4027433166,2269217681,79,1,1827937
1379,1574591927.587688,192.168.1.4,192.168.1.5,3721835128,4014795321,91,1,1828028
1380,1574591927.587715,192.168.1.4,192.168.1.5,3721835219,4014795321,24,1,1828052
1381,1574591927.63326,192.168.1.4,192.168.1.5,1663064971,4055228919,211,1,1828263
1382,1574591927.634011,192.168.1.4,192.168.1.5,1663065182,4055228919,60,1,1828323
1383,1574591928.324006,192.168.1.4,192.168.1.5,3785664702,3220319440,91,1,1828414
1384,1574591928.324927,192.168.1.4,192.168.1.5,3785664793,3220319440,24,1,1828438
1385,1574591928.6649,192.168.1.4,192.168.1.5,2885041561,457412322,53,1,1828491
1386,1574591928.664985,192.168.1.4,192.168.1.5,2885041614,457412322,24,1,1828515
1387,1574591928.668257,192.168.1.4,192.168.1.5,2520484341,2267122723,91,1,1828606
1388,1574591928.668701,192.168.1.5,192.168.1.4,2267122723,2520484432,539,0,1828067
1389,1574591928.703998,192.168.1.4,192.168.1.5,2520484432,2267123262,178,1,1828245
1390,1574591928.704512,192.168.1.5,192.168.1.4,2267123262,2520484610,73,0,1828172
1391,1574591928.770572,192.168.1.5,192.168.1.4,457412322,2885041638,24,0,1828148
1392,1574591928.7735,192.168.1.5,192.168.1.4,143592317,1502380542,715,0,1827433
1393,1574591928.817058,192.168.1.4,192.168.1.5,1502380542,143593032,186,1,1827619
1394,1574591928.85865,192.168.1.4,192.168.1.5,3417776879,2940307866,53,1,1827672
1395,1574591928.85875,192.168.1.4,192.168.1.5,3417776932,2940307866,24,1,1827696
1396,1574591928.980102,192.168.1.4,192.168.1.5,2585295723,1633043754,91,1,1827787
1397,1574591928.980692,192.168.1.5,192.168.1.4,1633043754,2585295814,539,0,1827248
1398,1574591928.980786,192.168.1.4,192.168.1.5,1799130452,3462891922,91,1,1827339
1399,1574591928.981129,192.168.1.5,192.168.1.4,3462891922,1799130543,539,0,1826800
1400,1574591929.020889,192.168.1.4,192.168.1.5,2585295814,1633044293,2070,1,1828870
1401,1574591929.021116,192.168.1.4,192.168.1.5,1799130543,3462892461,178,1,1829048
1402,1574591929.021567,192.168.1.5,192.168.1.4,3462892461,1799130721,73,0,1828975
1403,1574591929.062641,192.168.1.4,192.168.1.5,2585297884,1633044293,599,1,1829574
1404,1574591929.071373,192.168.1.5,192.168.1.4,1633044293,2585298483,86,0,1829488
1405,1574591929.072637,192.168.1.5,192.168.1.4,1633044379,2585298483,108,0,1829380
1406,1574591929.073869,192.168.1.5,192.168.1.4,1633044487,2585298483,270,0,1829110
1407,1574591929.105042,192.168.1.4,192.168.1.5,2585298483,1633044757,617,1,1829727
1408,1574591929.105484,192.168.1.5,192.168.1.4,1633044757,2585299100,53,0,1829674
1409,1574591929.115772,192.168.1.4,192.168.1.5,2585299100,1633044810,699,1,1830373
1410,1574591929.117097,192.168.1.5,192.168.1.4,1633044810,2585299799,61,0,1830312
1411,1574591929.118258,192.168.1.5,192.168.1.4,1633044871,2585299799,57,0,1830255
1412,1574591929.118765,192.168.1.5,192.168.1.4,1633044928,2585299799,84,0,1830171
1413,1574591929.121416,192.168.1.5,192.168.1.4,2940307866,3417776956,24,0,1830147
1414,1574591929.123137,192.168.1.5,192.168.1.4,2998718711,1563202070,343,0,1829804
1415,1574591929.12349,192.168.1.4,192.168.1.5,1563202070,2998719054,99,1,1829903
1416,1574591929.123831,192.168.1.5,192.168.1.4,2998719054,1563202169,382,0,1829521
1417,1574591929.13528,192.168.1.4,192.168.1.5,1563202169,2998719436,2266,1,1831787
1418,1574591929.13615,192.168.1.5,192.168.1.4,2998719436,1563204435,74,0,1831713
1419,1574591929.136263,192.168.1.5,192.168.1.4,2998719510,1563204435,261,0,1831452
1420,1574591929.136568,192.168.1.4,192.168.1.5,1563204435,2998719771,79,1,1831531
1421,1574591929.136679,192.168.1.4,192.168.1.5,1563204514,2998719771,79,1,1831610
1422,1574591929.159553,192.168.1.4,192.168.1.5,2585299799,1633045012,100,1,1831710
1423,1574591929.160418,192.168.1.5,192.168.1.4,1633045012,2585299899,57,0,1831653
1424,1574591929.161116,192.168.1.4,192.168.1.5,2585299899,1633045069,369,1,1832022
1425,1574591929.161404,192.168.1.5,192.168.1.4,1633045069,2585300268,61,0,1831961
1426,1574591930.02667,192.168.1.4,192.168.1.5,4176647221,2031149428,91,1,1832052
1427,1574591930.027511,192.168.1.5,192.168.1.4,2031149428,4176647312,539,0,1831513
1428,1574591930.080873,192.168.1.4,192.168.1.5,4176647312,2031149967,2070,1,1833583
1429,1574591930.12232,192.168.1.4,192.168.1.5,4176649382,2031149967,3188,1,1836771
1430,1574591930.126231,192.168.1.5,192.168.1.4,2031149967,4176652570,148,0,1836623
1431,1574591930.159924,192.168.1.4,192.168.1.5,2712076512,3586011442,91,1,1836714
1432,1574591930.160457,192.168.1.5,192.168.1.4,3586011442,2712076603,539,0,1836175
1433,1574591930.161509,192.168.1.4,192.168.1.5,4176652570,2031150115,73,1,1836248
1434,1574591930.16219,192.168.1.5,192.168.1.4,2031150115,4176652643,522,0,1835726
1435,1574591930.199401,192.168.1.4,192.168.1.5,4176652643,2031150637,467,1,1836193
1436,1574591930.199815,192.168.1.4,192.168.1.5,2712076603,3586011981,1440,1,1837633
1437,1574591930.202119,192.168.1.5,192.168.1.4,2031150637,4176653110,522,0,1837111
1438,1574591930.205455,192.168.1.5,192.168.1.4,1600952084,1085852998,24,0,1837087
1439,1574591930.205912,192.168.1.4,192.168.1.5,1085852998,1600952108,24,1,1837111
1440,1574591930.207759,192.168.1.5,192.168.1.4,342296650,2127254088,343,0,1836768
1441,1574591930.208418,192.168.1.4,192.168.1.5,2127254088,342296993,99,1,1836867
1442,1574591930.208797,192.168.1.5,192.168.1.4,342296993,2127254187,382,0,1836485
1443,1574591930.21928,192.168.1.4,192.168.1.5,2127254187,342297375,2266,1,1838751
1444,1574591930.220394,192.168.1.5,192.168.1.4,342297375,2127256453,74,0,1838677
1445,1574591930.220507,192.168.1.5,192.168.1.4,342297449,2127256453,231,0,1838446
1446,1574591930.220719,192.168.1.4,192.168.1.5,2127256453,342297680,79,1,1838525
1447,1574591930.220786,192.168.1.4,192.168.1.5,2127256532,342297680,79,1,1838604
1448,1574591930.235031,192.168.1.4,192.168.1.5,4176653110,2031151159,467,1,1839071
1449,1574591930.240502,192.168.1.5,192.168.1.4,980619970,3738481531,343,0,1838728
1450,1574591930.241303,192.168.1.4,192.168.1.5,3738481531,980620313,99,1,1838827
1451,1574591930.241782,192.168.1.5,192.168.1.4,980620313,3738481630,382,0,1838445
1452,1574591930.242175,192.168.1.4,192.168.1.5,2712078043,3586011981,2386,1,1840831
1453,1574591930.250581,192.168.1.5,192.168.1.4,3586011981,2712080429,86,0,1840745
1454,1574591930.257002,192.168.1.4,192.168.1.5,3738481630,980620695,2266,1,1843011
1455,1574591930.258356,192.168.1.5,192.168.1.4,980620695,3738483896,74,0,1842937
1456,1574591930.25853,192.168.1.5,192.168.1.4,980620769,3738483896,231,0,1842706
1457,1574591930.25886,192.168.1.4,192.168.1.5,3738483896,980621000,79,1,1842785
1458,1574591930.25898,192.168.1.4,192.168.1.5,3738483975,980621000,79,1,1842864
1459,1574591930.264856,192.168.1.5,192.168.1.4,3586012067,2712080429,108,0,1842756
1460,1574591930.266918,192.168.1.4,192.168.1.5,3496074704,2268399124,91,1,1842847
1461,1574591930.266974,192.168.1.4,192.168.1.5,2773292371,2836221380,91,1,1842938
1462,1574591930.267949,192.168.1.5,192.168.1.4,2268399124,3496074795,539,0,1842399
1463,1574591930.268457,192.168.1.5,192.168.1.4,2836221380,2773292462,539,0,1841860
1464,1574591930.268835,192.168.1.5,192.168.1.4,3586012175,2712080429,336,0,1841524
1465,1574591930.283605,192.168.1.4,192.168.1.5,2712080429,3586012511,586,1,1842110
1466,1574591930.286917,192.168.1.5,192.168.1.4,3586012511,2712081015,53,0,1842057
1467,1574591930.300658,192.168.1.4,192.168.1.5,2712081015,3586012564,53,1,1842110
1468,1574591930.310267,192.168.1.4,192.168.1.5,3496074795,2268399663,173,1,1842283
1469,1574591930.310708,192.168.1.5,192.168.1.4,2268399663,3496074968,73,0,1842210
1470,1574591930.313573,192.168.1.4,192.168.1.5,2773292462,2836221919,2070,1,1844280
1471,1574591930.342108,192.168.1.4,192.168.1.5,2712081068,3586012564,5792,1,1850072
1472,1574591930.342258,192.168.1.4,192.168.1.5,2712086860,3586012564,8688,1,1858760
1473,1574591930.342422,192.168.1.4,192.168.1.5,2712095548,3586012564,1926,1,1860686
1474,1574591930.34245,192.168.1.4,192.168.1.5,2712097474,3586012564,55,1,1860741
1475,1574591930.343979,192.168.1.5,192.168.1.4,3586012564,2712097529,61,0,1860680
1476,1574591930.354339,192.168.1.4,192.168.1.5,2773294532,2836221919,809,1,1861489
1477,1574591930.358705,192.168.1.5,192.168.1.4,2836221919,2773295341,86,0,1861403
1478,1574591930.359152,192.168.1.5,192.168.1.4,2836222005,2773295341,108,0,1861295
1479,1574591930.364194,192.168.1.5,192.168.1.4,2998719771,1563204593,24,0,1861271
1480,1574591930.366335,192.168.1.5,192.168.1.4,2836222113,2773295341,480,0,1860791
1481,1574591930.366669,192.168.1.5,192.168.1.4,2836222593,2773295341,123,0,1860668
1482,1574591930.393801,192.168.1.4,192.168.1.5,2773295341,2836222716,617,1,1861285
1483,1574591930.394181,192.168.1.5,192.168.1.4,2836222716,2773295958,53,0,1861232
1484,1574591930.397857,192.168.1.4,192.168.1.5,2773295958,2836222769,749,1,1861981
1485,1574591930.438208,192.168.1.4,192.168.1.5,2773296707,2836222769,415,1,1862396
1486,1574591930.442347,192.168.1.5,192.168.1.4,2836222769,2773297122,61,0,1862335
1487,1574591930.444873,192.168.1.5,192.168.1.4,2836222830,2773297122,85,0,1862250
1488,1574591930.485738,192.168.1.4,192.168.1.5,2773297122,2836222915,253,1,1862503
1489,1574591930.486318,192.168.1.5,192.168.1.4,2836222915,2773297375,61,0,1862442
1490,1574591930.486604,192.168.1.5,192.168.1.4,2836222976,2773297375,57,0,1862385
1491,1574591930.48712,192.168.1.5,192.168.1.4,2836223033,2773297375,85,0,1862300
1492,1574591930.52752,192.168.1.4,192.168.1.5,2773297375,2836223118,253,1,1862553
1493,1574591930.529661,192.168.1.5,192.168.1.4,2836223118,2773297628,61,0,1862492
1494,1574591930.670699,192.168.1.5,192.168.1.4,1633045130,2585300268,253,0,1862239
1495,1574591930.710063,192.168.1.4,192.168.1.5,2585300268,1633045383,446,1,1862685
1496,1574591930.710895,192.168.1.5,192.168.1.4,1633045383,2585300714,57,0,1862628
1497,1574591930.711277,192.168.1.5,192.168.1.4,1633045440,2585300714,61,0,1862567
1498,1574591930.711581,192.168.1.5,192.168.1.4,1633045501,2585300714,86,0,1862481
1499,1574591930.734894,192.168.1.5,192.168.1.4,2836223179,2773297628,143,0,1862338
1500,1574591930.768116,192.168.1.4,192.168.1.5,2585300714,1633045587,446,1,1862784
1501,1574591930.768765,192.168.1.5,192.168.1.4,1633045587,2585301160,57,0,1862727
1502,1574591930.771763,192.168.1.5,192.168.1.4,1633045644,2585301160,61,0,1862666
1503,1574591930.786462,192.168.1.4,192.168.1.5,2773297628,2836223322,253,1,1862919
1504,1574591930.788004,192.168.1.5,192.168.1.4,2836223322,2773297881,61,0,1862858
1505,1574591930.798758,192.168.1.5,192.168.1.4,2836223383,2773297881,88,0,1862770
1506,1574591930.841187,192.168.1.4,192.168.1.5,2773297881,2836223471,253,1,1863023
1507,1574591930.842414,192.168.1.5,192.168.1.4,2836223471,2773298134,61,0,1862962
1508,1574591931.531435,192.168.1.4,192.168.1.5,2931221506,203466928,91,1,1863053
1509,1574591931.531463,192.168.1.4,192.168.1.5,2931221597,203466928,24,1,1863077
1510,1574591932.332513,192.168.1.4,192.168.1.5,2329716299,22396511,91,1,1863168
1511,1574591932.332536,192.168.1.4,192.168.1.5,2329716390,22396511,24,1,1863192
1512,1574591933.698369,192.168.1.4,192.168.1.5,2332609299,2794917287,91,1,1863283
1513,1574591933.698743,192.168.1.5,192.168.1.4,2794917287,2332609390,539,0,1862744
1514,1574591933.736196,192.168.1.4,192.168.1.5,2332609390,2794917826,2070,1,1864814
1515,1574591933.778208,192.168.1.4,192.168.1.5,2332611460,2794917826,826,1,1865640
1516,1574591933.780654,192.168.1.5,192.168.1.4,2794917826,2332612286,115,0,1865525
1517,1574591933.780954,192.168.1.5,192.168.1.4,2794917941,2332612286,115,0,1865410
1518,1574591933.781183,192.168.1.5,192.168.1.4,3051477334,1325427035,24,0,1865386
1519,1574591933.781587,192.168.1.5,192.168.1.4,2794918056,2332612286,337,0,1865049
1520,1574591933.78178,192.168.1.5,192.168.1.4,2794918393,2332612286,177,0,1864872
1521,1574591933.814276,192.168.1.4,192.168.1.5,2332612286,2794918570,375,1,1865247
1522,1574591933.814692,192.168.1.5,192.168.1.4,2794918570,2332612661,60,0,1865187
1523,1574591933.81528,192.168.1.4,192.168.1.5,2332612661,2794918630,60,1,1865247
1524,1574591933.858191,192.168.1.4,192.168.1.5,2332612721,2794918630,657,1,1865904
1525,1574591933.860549,192.168.1.5,192.168.1.4,2794918630,2332613378,68,0,1865836
1526,1574591933.86085,192.168.1.5,192.168.1.4,2794918698,2332613378,64,0,1865772
1527,1574591933.860956,192.168.1.5,192.168.1.4,2794918762,2332613378,64,0,1865708
1528,1574591933.862604,192.168.1.5,192.168.1.4,2794918826,2332613378,170,0,1865538
1529,1574591933.862752,192.168.1.5,192.168.1.4,2794918996,2332613378,181,0,1865357
1530,1574591933.904818,192.168.1.4,192.168.1.5,2332613378,2794919177,174,1,1865531
1531,1574591933.946327,192.168.1.4,192.168.1.5,2332613552,2794919177,460,1,1865991
1532,1574591933.947301,192.168.1.5,192.168.1.4,2794919177,2332614012,68,0,1865923
1533,1574591933.948545,192.168.1.5,192.168.1.4,2794919245,2332614012,64,0,1865859
1534,1574591933.959335,192.168.1.5,192.168.1.4,936152241,3959882675,24,0,1865835
1535,1574591933.95989,192.168.1.4,192.168.1.5,3959882675,936152266,24,1,1865859
1536,1574591933.960748,192.168.1.5,192.168.1.4,2929085892,385150498,24,0,1865835
1537,1574591933.961126,192.168.1.4,192.168.1.5,385150498,2929085916,24,1,1865859
1538,1574591933.961824,192.168.1.5,192.168.1.4,2267123335,2520484610,573,0,1865286
1539,1574591933.994762,192.168.1.4,192.168.1.5,2520484610,2267123908,302,1,1865588
1540,1574591934.782632,192.168.1.4,192.168.1.5,1325427035,3051477358,91,1,1865679
1541,1574591934.782789,192.168.1.4,192.168.1.5,1325427126,3051477358,24,1,1865703
1542,1574591935.450455,192.168.1.4,192.168.1.5,3757065986,2183154322,91,1,1865794
1543,1574591935.451203,192.168.1.5,192.168.1.4,2183154322,3757066077,539,0,1865255
1544,1574591935.479822,192.168.1.4,192.168.1.5,3757066077,2183154861,2070,1,1867325
1545,1574591935.522555,192.168.1.4,192.168.1.5,3757068147,2183154861,2038,1,1869363
1546,1574591935.533899,192.168.1.5,192.168.1.4,2183154861,3757070185,148,0,1869215
1547,1574591935.534306,192.168.1.5,192.168.1.4,2183155009,3757070185,614,0,1868601
1548,1574591935.556391,192.168.1.4,192.168.1.5,3757070185,2183155623,280,1,1868881
1549,1574591935.561934,192.168.1.4,192.168.1.5,1559215857,1406839899,91,1,1868972
1550,1574591935.56428,192.168.1.5,192.168.1.4,1406839899,1559215948,539,0,1868433
1551,1574591935.598345,192.168.1.4,192.168.1.5,3757070465,2183155623,656,1,1869089
1552,1574591935.602603,192.168.1.5,192.168.1.4,2183155623,3757071121,699,0,1868390
1553,1574591935.603654,192.168.1.4,192.168.1.5,1559215948,1406840438,2070,1,1870460
1554,1574591935.646497,192.168.1.4,192.168.1.5,1559218018,1406840438,809,1,1871269
1555,1574591935.650413,192.168.1.5,192.168.1.4,1406840438,1559218827,86,0,1871183
1556,1574591935.650841,192.168.1.5,192.168.1.4,1406840524,1559218827,108,0,1871075
1557,1574591935.651538,192.168.1.5,192.168.1.4,1406840632,1559218827,373,0,1870702
1558,1574591935.671253,192.168.1.4,192.168.1.5,3757071121,2183156322,689,1,1871391
1559,1574591935.673406,192.168.1.5,192.168.1.4,2267123908,2520484912,570,0,1870821
1560,1574591935.720415,192.168.1.4,192.168.1.5,2520484912,2267124478,302,1,1871123
1561,1574591935.720917,192.168.1.4,192.168.1.5,1559218827,1406841005,1796,1,1872919
1562,1574591935.726727,192.168.1.5,192.168.1.4,1406841005,1559220623,53,0,1872866
1563,1574591935.72701,192.168.1.5,192.168.1.4,1406841058,1559220623,61,0,1872805
1564,1574591935.727312,192.168.1.5,192.168.1.4,1406841119,1559220623,57,0,1872748
1565,1574591935.728332,192.168.1.5,192.168.1.4,2267124478,2520485214,569,0,1872179
1566,1574591935.778733,192.168.1.4,192.168.1.5,2520485214,2267125047,239,1,1872418
1567,1574591936.124833,192.168.1.4,192.168.1.5,4027433245,2269217681,91,1,1872509
1568,1574591936.125373,192.168.1.5,192.168.1.4,2269217681,4027433336,539,0,1871970
1569,1574591936.166013,192.168.1.4,192.168.1.5,4027433336,2269218220,2070,1,1874040
1570,1574591936.206332,192.168.1.4,192.168.1.5,4027435406,2269218220,1784,1,1875824
1571,1574591936.208854,192.168.1.5,192.168.1.4,2269218220,4027437190,148,0,1875676
1572,1574591936.210796,192.168.1.5,192.168.1.4,2269218368,4027437190,502,0,1875174
1573,1574591936.240079,192.168.1.4,192.168.1.5,4027437190,2269218870,280,1,1875454
1574,1574591936.286437,192.168.1.4,192.168.1.5,4027437470,2269218870,546,1,1876000
1575,1574591936.311351,192.168.1.5,192.168.1.4,3839650330,1973252935,343,0,1875657
1576,1574591936.311763,192.168.1.4,192.168.1.5,1973252935,3839650673,99,1,1875756
1577,1574591936.312205,192.168.1.5,192.168.1.4,3839650673,1973253034,382,0,1875374
1578,1574591936.321122,192.168.1.5,192.168.1.4,445367315,1589908587,343,0,1875031
1579,1574591936.326779,192.168.1.4,192.168.1.5,1589908587,445367658,99,1,1875130
1580,1574591936.327146,192.168.1.5,192.168.1.4,445367658,1589908686,382,0,1874748
1581,1574591936.341891,192.168.1.4,192.168.1.5,1589908686,445368040,2266,1,1877014
1582,1574591936.343102,192.168.1.5,192.168.1.4,445368040,1589910952,74,0,1876940
1583,1574591936.343247,192.168.1.4,192.168.1.5,1973253034,3839651055,2266,1,1879206
1584,1574591936.343641,192.168.1.4,192.168.1.5,1589910952,445368114,79,1,1879285
1585,1574591936.343807,192.168.1.4,192.168.1.5,1589911031,445368114,79,1,1879364
1586,1574591936.344936,192.168.1.5,192.168.1.4,3839651055,1973255300,74,0,1879290
1587,1574591936.345428,192.168.1.4,192.168.1.5,1973255300,3839651129,79,1,1879369
1588,1574591936.345528,192.168.1.4,192.168.1.5,1973255379,3839651129,79,1,1879448
1589,1574591936.348451,192.168.1.5,192.168.1.4,3839651129,1973255458,231,0,1879217
1590,1574591936.348799,192.168.1.5,192.168.1.4,445368114,1589911110,231,0,1878986
